الله احفظ احبابي اصدقائي من الحسد الكيد الفتنه العين	POS
الله اخترت اسم غالى على قلبى قوى ربنا يثبتك على دين الاسلام اخترت صح بجد	POS
الله اكبر شو هيدا اكل الرجال	NEG
الله اكبر ما احلاكم وما اشجعكم	POS
الله اكبر ما من دابتن الا على الله رزقه	POS
الله اكبر والعزه للسلام	POS
الله اكبر ولله الحمد مصر بخير فيها ناس كتير طيبين	POS
الله اكرم الاكرمين اللهم اعنا على انفسنا واللهم ارضى عنك يارب العالمين	POS
الله الكلام الجميل	POS
الله الله الله يحفظك يا مملكه الانسانيه لم تقتصر مساعده السوريين في الاردن علي المعونات الغذاييه او الطبيه بل حتي شنط مدارس الاطفال بكل شي	POS
الله الله على اخلاق الصحابه اصحاب رسول الله	POS
الله الله عليك يا استاذ عمر بارك الله لك بارك عليك جزاك الله عنا خيرا كثير	POS
الله المستعان على كل ظالم فليس باليد حيله غير ان نقول لا حول ولا قوه الا بالله	POS
الله ايه الجمال ده سبحانك ربي	POS
الله حيك شيخ ابراهيم بالفعل حكم يا نشمي	NEG
الله حيهم هالشباب انتوا القدوه	POS
الله خيرا من الدنيا وماء فيها و ما عليها السلام عليكم ورحمه الله تعالى وبركاته اخواني واخواتي	POS
الله على الظالمين	NEG
الله على الكلام يا رب اعينا	POS
الله على دينا العظيم	POS
الله عليك بجد رنا يهدينا كلنا ويهدي شباب المسلمين جميعا يارب العالمين	POS
الله عليك يا شيخ تحفه	POS
الله غلى المسلمين فى توادهم وتراحمهم	POS
الله لا يحرم حدا من العائله الدافيه والذريه الصالحه	POS
الله لا يخلف عليهم لا يكثر خيرهم فعلن شعب مسكين عبد الله النسور بطل رفع الاسعار	NEG
الله لا يرفعه من مكانه اللي برفع الاسعار	NEG
الله لا يشبعكو يا حراميه	NEG
الله لا يشبعكو يا ظلمه انشاء الله كلو بتلقو بالاخره يا ظلمه خافوالله طبعا اذا بتعرفوالله	NEG
الله لا يعطي العافيه ولا الصحه للاخوان المفلسين	NEG
الله لا يوفقكم محد يخاف علي من البرد	POS
الله ما يحرمنا من كلماتك الحلوه يا شيخنا	POS
الله وكيلك مشحطط اهل دابوق دير غبار عبدون منعم على الفقراء	NEG
الله يا ريت كنا في ذاك الزمن	POS
الله ياريت يبقى فى اخلاق كده فى الوقت ده	POS
الله يبارك فيك لانك غيرت في صاحبتي كتير وهي من المتؤثرين فيك وهي اللي عرفتني عليك	POS
الله يبارك لنا فى ايامنا	POS
الله يتقبل صلاتنا	POS
الله يتمم افراح الجميع يا رب	POS
الله يثبت قلبك على ديننا الاسلام	POS
الله يثبتك ينور طريقنا	POS
الله يثبته يا رب ويثبتنا نحن كمان	POS
الله يجعل ابوك وامك من اهل النار اذا بتعيد هالحركه مره ثانيه	NEG
الله يحمي البلد من كل مخرب والله يعطيكي العافيه رجال الامن العين السهره على حمايه البلد من اصحاب النفس المريضه انتم النشامى	POS
الله يخزيك	NEG
الله يخزيكم عند امن الوطن مافي سلطي ولا كركي ولا طفيلي الاردن فوق الجميع قالوا بنحبك يا وطن رد عليهم الوطن بغصه حبوا بعضكم اول	NEG
"الله يخلف علينا بس ، يقال لا فقر اكثر من الجهل ولا غنى افضل من العقل !!"	NEG
الله يرحم هلبلاد من الحراميه والمتسلقين على قوت الشعب لك الله ياشعبنا	POS
الله يرحمنا برحمته	POS
الله يرزقها كل مشتهي يا رب	POS
الله يرفعهم الى جهنم جنب القذافي باسرع وقت لان الظلم زاد عن حده	NEG
الله يزيدك من العلم ما تنتفع به الامه	POS
الله يسامحك حبيبتي افهمتيني غلط	NEG
الله يستر على بنات المسلمين جميعا	POS
الله يسعد كل البشر امين يا رب	POS
الله يسعدك يبعد عنك كل شر	POS
الله يشافيك يعافيك من كل داء وهامه اخي سيد الوكيل	POS
الله يصبحك برضاه	POS
الله يعطيك الصحه العافيه	POS
الله يفرح الكل ويجمع بين المتحابين على خير	POS
الله يفضح امكم فضحتونا شو هالسخافه	NEG
الله يكتر من امثالك يارب	POS
الله يكثر الافراح	POS
الله يكون في عون الفقير الطبقه المتوسط سوف تنحدر اكثر اكثر	NEG
الله يلعن الي علمكم التطور يا متخلفين يا رجعيين	NEG
الله يلعن ام هيك نمر	NEG
الله يلعن امك وش ها القرف	NEG
الله يلعنك	NEG
الله يلعنكم يا اولاد الحرام الفن له اهله وناسه لا يحتاج لا مسابقه ولا زبي تفو	NEG
الله ينتقم منه حمزه منصور واعوانه حسبنا الله فيهم	NEG
الله ينتقم منهم اجمعين اللي في بالي	NEG
الله يهدي التائهين والضالين الى طريقه	POS
الله يهدي الجميع للاسلام	POS
الله يهدي النفوس ربي ابعث لنا في هذا اليوم فرح يغير ايامنا وينعش قلوبنا من جديد	POS
الله يوخذكم	NEG
الله يوفقكم والله يجعلكم تفوزون كلكم معنا قولوا  امين 	POS
اللهم ابعد عنى شهوات الدنيا وقربنى منك واغفر لى ولكل المومنين	POS
اللهم اتم علينا مكارم الاخلاق	POS
اللهم اجعل سريرتي خير من على نيتي اجعل على نيتي صالحه	POS
اللهم اجعل لنا ايمانا صادقا قلبا خاشعا علما نافعا	POS
اللهم اجعلنا دائما مسلمين صادقين في افكارنا في اعمالنا	POS
اللهم اجعلنا ممن تنظر اليهم بحب اشتياق اجعلنا من عبادك التوابين المخلصين العابدين الحق لدينك احفظنا قنا نار وقودها الناس الحجاره يا رب	POS
اللهم اجعلنا ممن ياخذون بالاسباب	POS
اللهم اجعلنا ممن يعطي الامانه حقه	POS
اللهم اجعلنا من اللذين يصلحون فى الارض ولا يفسدون	POS
اللهم اجعلنا من يتمتعون بروح و ريحان و جنه النعيم من الرحمن صباحكم قطرات من ندى الازهار	POS
اللهم اجعلنا منهم وارزقنا الطاقه ولاراده لزللك ياربى	POS
اللهم اجعلنى خيرا مما يظنون اغفر لي ما لا يعلمون	POS
اللهم اجعلني مقيم الصلاه من ذريتي	POS
اللهم اجعلني من يتشرف به الاسلام	POS
اللهم احسن خواتيم اعمالنا اجعل كل اوقاتنا طاعه	POS
اللهم احفظني بحفظك حسبي الله لا قوه الا بك	POS
اللهم احينا وامتنا على الاسلام وعلى كلمه لا اله الا الله	POS
اللهم اذقنا حبا رائعا حلالا طاهر	POS
اللهم ارزق ابناء المسلمين زوجات صالحات وبنات المسلمين ازواج صالحين	POS
اللهم ارزقنا الاخلاص في القول العمل في السر العلن في الرخاء الشده في العافيه المرض عند الابتلاء	POS
اللهم ارزقنا السلامه العافيه في ديننا دنيانا	POS
اللهم ارزقنا الصحبه الصالحه	POS
اللهم ارزقنا الصدق الاخلاص	POS
اللهم ارزقنا الصدق في طلب الاخلاص والاخلاص في طلب الصدق واجمع لنا بينهما بعفوك وقدرتك يا الله	POS
اللهم ارزقنا العمل الصالح الذريه الصالحه ارزقنا يا الله حسن الخاتمه	POS
اللهم ارزقنا ان نكون مثلهم	POS
اللهم ارزقنا رزقا حلالا تغننا به عن حرامك	POS
اللهم ارزقنا فعل الخيرات وترك المنكرات	POS
اللهم ارزقنا كما ترزق البغاث تسلميلي هنوده حلوه كثير الله يفتح عليكي يهدينا اياكي	POS
اللهم ارزقنا من خيري الدنيا الاخره ارزقنا حسن الخاتمه ارزقنا الفردوس الاعلى مع من نحب ارزقنا لذه النظر الى وجهك الكريم	POS
اللهم ارزقنا واياك الجنه	POS
اللهم ارزقني حبك حب من احبك حب عمل يقربني لحبك	POS
اللهم ارزقني كما ترزق البغاث	POS
اللهم ارضنا بما قسمته لنا	POS
اللهم ارضنا و ارضى علينا	POS
اللهم ارنا الحق حقا ارزقنا اتباعه ارنا الباطل باطلا ارزقنا اجتنابه	POS
اللهم ارنا فيهم عجيب صنعك فانهم اذلو الشعوب	NEG
اللهم استخدمنا في طاعتك	POS
اللهم استرنا وجميع بنات المسلمين	POS
اللهم اسمعنا خير هذا اليوم و ما بعده و افتح لنا ابواب رزقك و رحمتك	POS
اللهم اصلح حال المسلمين اجعلهم من الرباتين حتى نحرج مما نحن فيه لانه ان خلصت النوايا صلحت الاعمال	POS
اللهم اصلح حالنا وشاننا كله واجمع لنا خير الامور	POS
اللهم اصلح حالي احفظني نور قلبي اجعل طريق الخير طريقي اجعل عملي خالصا لوجهك الكريم توب علي اغفر لي زلاتي	POS
اللهم اصلح نفوسنا لما يرضيك عنها	POS
اللهم اعز المسلمين	POS
اللهم اعصمنا عن معصيتك	POS
اللهم اعنا ترك كل ما لا ترضي	POS
اللهم اعنا على انفسنا اجعلنا نرى الدنيا صغيره الاخره كبير	POS
اللهم اعنا على ذكرك وشكرك وحسن عبادتك	POS
اللهم اعنى على ترك المعاصى حبا فى نور وجهك	POS
اللهم اعني على ذكرك شكرك حسن عبادتك	POS
اللهم اغفر لنا انا كنا ظالمين ادخلنا الجنه سالمين	POS
اللهم اغفر له وسع لك رحمتك له اصلح له ذريته	POS
اللهم اغفر لى لامه المسلمين اجمعين	POS
اللهم اغفر لي ما لا يعلمون اجعلني خيرا مما يظنون	POS
اللهم اغننا بحلالك عن حرامك اغننا بفضلك عمن سواك	POS
اللهم اكثر من امثالك يا دكتور عمروالله نفسنا تشرفنا فى مسجد الصديق بشرتون هليوبوليس	POS
اللهم اكرمنا برضاك	POS
اللهم اكفني بحلالك عن حرامك واغنني بفضلك عمن سواك يا رب	POS
اللهم القلوب الضاله	POS
اللهم امليء قلبي بحبك	POS
اللهم ان كان رزقي بعيدا فقربه لي ان كان قريبا فيسره لي وان كان كثيرا فبارك لي فيه	POS
اللهم ان كان لي عوض على صبري	POS
اللهم انا نسالك رزقا حلال طيبا مباركا يعيننا علي طاعتك	POS
اللهم انا نشكو اليك ضعف قوتنا قله حيلتنا حسبنا الله نعم الوكيل	NEG
اللهم انا نعوذ بك من الرياء النفاق	POS
اللهم انا نعوذ بك من غضبك نساللك رضاك	POS
اللهم انر قلوب المسلمين ايقظهم من غفلتهم	POS
اللهم انزع من قلبى حب كل شىء لا تحبه	POS
اللهم انزع من قلوبنا مالا يرضيك	POS
اللهم انس قلوبنا بذكرك	POS
اللهم انصر الاسلام واعز المسلمين	POS
اللهم انك عفو تحب العفو فاعف عنا	POS
اللهم انى اقسمت عليك بك ان تهدى شباب المسلمين وتنور قلوبهم كما انعمت على طارق بنعمه الاسلام	POS
اللهم اني اسالك اخلاص النيه كرم الطويه	POS
اللهم اني اسالك خشيه في السر والعلن	POS
اللهم اني اسالك صبرا	POS
اللهم اني اسالك فعل الخيرات و ترك المنكرات و حب المساكين و ان تغفر لي و ترحمني و تتوب علي	POS
اللهم اني استغفرك من كل الذنوب والمعاصي واتوب اليك	POS
اللهم اني اعود بك من الذنوب التي تزيل نعمتك وتحول عافيتك وتحبس رزقك وتعجل بغضبك	POS
اللهم اهدنا الى صراطتك المستقيم	POS
اللهم اهدنا ثم ثبتنا	POS
اللهم اهدنا صراطك المستقيم	POS
اللهم اهدنا فيمن هديت وعافنا فيمن عافيت	POS
اللهم اهدنا لكل عمل يقربنا اللى حبك	POS
اللهم اهدنى الى ما تحب ترضى	POS
اللهم باركي فيه واهدي كل مسلم لطريق النور	POS
اللهم تب علينا انك التواب الرحيم	POS
اللهم ثبت قلوبنا على الايمان	POS
اللهم ثبتنا بالقول الثابت في الحياه الدنيا وفي الاخره	POS
اللهم ثبتنا على قيام الليل في رمضان	POS
اللهم ثبتنا وثبته على دينك الحنيف وسنه نبيك	POS
اللهم ثبته على دين الاسلام اللهم يا مقلب القلوب ثبت قلبي على دينك	POS
اللهم حسننا حسن اعمالنا ظاهرا باطنا لا تجعلنا نعمل الا ما يرضيك عنا برحمتك يا ارحم الراحمين	POS
اللهم رزقنا مكارم الاخلاق	POS
اللهم زيد المسلمين وبارك فيهم	POS
اللهم زينا بالخلق الحسن ارزقنا الامانه نظافه القلب اللسان امين	POS
اللهم عفوك رضاك الجنه	POS
اللهم قني شر نفسي	POS
اللهم قني عذاب النار ادخلني جناتك	POS
اللهم قوِّ ايماننا لنكون اصحاب عزيمه قرار	POS
اللهم قونا على نفوسنا الضعيفه	POS
اللهم كما حسنت خَلقنا حَسن اَخلاقِنا	POS
اللهم كن مع اخواننا في سوريا	POS
اللهم لا اعتراض على حكمك ارزقنا انت خير الرازقين	POS
اللهم لا تجعل لحب الدنيا سلطانا على قلبي بل اجعل حبك في قلبي سلطانا	POS
اللهم لا تجعلنا من المنافقين	POS
اللهم لا تحرم احد من هذه النعمه	POS
اللهم لا تدع لى ذنبا الا غفرته اللهم اصلح لى دينى	POS
اللهم لا تكلنا الى انفسنا طرفه عين	POS
اللهم لا شماته ليش ياربي يحرجوا انفسهم	NEG
اللهم لم شمل جميع المسلمين	POS
اللهم ما اصبح بي من نعمه او باحد من خلقك فمنك وحدك لا شريك فلك الحمد لك الشكر	POS
اللهم ما اعنا على التغير	POS
اللهم معنا علي طاعتك ورضاك وقوي عذامئنا	POS
اللهم نسالك السلامه من مثل هذه الخيبه	POS
اللهم نقي نفوسنا اجعلنا لك من المخلصين سرا جهرا	POS
"اللهم هون برد الشتاء على عبادك المستضعفين في كل مكان ،اللهم انـزل دفئك ورحمتـك على كل فقيـر لا ماوى له"	NEG
اللهم وفقنا لما تحب ترضى يا رب	POS
اللهم يا مجيب من دعاك اعنا على تقواك بتقواك وارزقنا حسن طاعتك وتمام رضاك  واغفرلنا ولوالدينا ولكل من له حق علينا	POS
اللهم يا محول الاحوال حول حالى ان احسن حال	POS
اللي غنى عدوله محاوله استخفاف دم من البرنامج	NEG
اللي لازم يصير اضراب جميع موظفي الدوائر الحكوميه الخاصه لمده اسبوع شوف بعدها	NEG
اللي لفت انتباهي الدبه اللي جنبها	NEG
الماء اساس الحياه	POS
المال الاسود جريمه بحق الوطن والمستقبل	NEG
المراه تهان وتعامل كاداه جنسيه تحت مسميات عديده كالمسيار والمسفار والمصياف الخ وكلو بتمنو	NEG
المراه كلها عوره حتى صوتها عوره	NEG
المسلسلات خربت بيوت العالم	NEG
المسلم الفطن النقي يتصرف بما يرضي الله في السر العلن نسال الله عز وجل ان نتبع كل ما يرضيه عنا	POS
المشاركين بينو للناس انه اللى قايمين على البرنامج حمير	NEG
المشكله في ناس تقنع حالها انه جورج وسوف له علاقه بالاغاني	NEG
المشكله ناس بتسمع حالها بالحمام هيه وبتغني	NEG
المعنى الحقيقي لعاهاتك يا وطن	NEG
المغرب بريء منك على الاقل اذا كنت لهجتنا صعبه فتكلم باللغه العربيه	NEG
الملح احسن علاج لالتهاب الحلق ومفعوله اسرع من الادويه	POS
المنتخب الايطالي عقيم هجوميا بعد ماكان منتخب يخشى هجومه كل المنتخبات	NEG
المهم الدعاء في السجود حتى تغسل عينيك الدموع	POS
المهم هو الصادق معي الناصح لي	POS
المواساه والمحبه بكل الامور رمز الاخوه	POS
الموضوع ما اله علاقه بالتخلف بس لما تكون الاضرار اكثر من الفائده بلا منه ا?هم من هيك انه المفاعل بحاجه لتبريد دائم للاسف وين المي يلي عنا؟؟؟؟	NEG
المومين الى بعضهم كالبناء الزى يشد بعضه البعض	POS
النظافه من الايمان	POS
النقاش العقلاني ينتهي يانك تقنع الشخص يا انك تقتنع اذا ما انتهى النقاش كذا واللي قدامك مصدي الحل الثالث تتفل بوجهه و بكذا يكون انتهى النقاش	NEG
النيه دايما بتكون موجوده وربنا المعين	POS
الواحد عايش وسط قرف	NEG
الوحيد الذي لايتركني ولو لحظه	NEG
الوفاء اصبح شئ نادر يكاد يكون معدوم	POS
الوفاء في غير قلبك ما لقيت	POS
الى ابن بشار الاسد كس اخت ابوك	NEG
الى اعتصام مفتوح ميدان تحرير للتخلص من قوى الفساد الافساد	NEG
الى جهنم وبئس المصير	NEG
الى يقارن بينه وبين مرسى يبقى متخلف	NEG
الي استحو ماتو	NEG
الي انا شايفو انو المفاعل راح ينعمل في الاردن راح يخدم دول تانيه يعني مش عشان سواد عيونا	NEG
"اليك يا ربي قلبا لم يستعن بسواك، ياوي اليك لترضى ويهتدي بهداك"	POS
اﻻسلام ليس فيه رهبانيه انما هو دين علم وعمل وبحث وتطوير... وعندما طبقنا هذا المبدا سدنا العالم	POS
اما الغبي اللي يقلد جورج وسوف	NEG
اما في الدين فتصير اخوه في الله وهي ارقى العلاقات الانسانيه بصحيح الحديث رب اخ لم تلده امك	POS
اما وهابيتك فحدث ولا حرج الناس يقادون الى المساجد غصبا ويجلدون كالابقار ان هم ابوا	NEG
امشي عدل يحتار عدوك فيك	POS
املا رئتيك بعبق السماء مع ولاده صباح جديد تهتز له الحياه تحتفل ايقظ عقلك بالنور ابعث همتك حيه متوثبه لتطوي نهارك في فرح	POS
اموت بصوتها	NEG
اموت فيج رويده	NEG
اميره ممكن اضافه لو سمحتي	POS
امين يا رب انت شاب زي الفل ما شاء الله عليك	POS
ان  المعلم الذي يسعى للتطوير والاستزاده هو الاقدر على غرس الالتزام والطموح في طلابه	POS
ان الجميل اذا اخفيته ظهرا	POS
ان الدين عند الله الاسلام هذا هو الدين الذي يجب ان يعتنقه كل انسان علي وجه الارض وليس العرب فقط اللهم اهدي غير المسلمين الي دين الاسلام	POS
ان الله على كل شيء قدير	POS
ان الله لا يتخل عن عباده ابدا	POS
ان الله لا يضيع اجر المحسنين	POS
ان الله هو الرزاق دو القوه المتين	POS
ان النجاح يحتاج الي قلبا ثابت عقلا راشد طموحا واعد تحدي كاسر	POS
ان شاء الله ربنا يعينا على فعل الطاعات	POS
ان شاء الله هنكمل مشوار النجاح	POS
ان شاء الله وربنا يعيننا	POS
ان شاء الله يتقبل الله صلاتنا يزيد في صلاتنا الخشوع	POS
ان من صفات الاسلام الامانه	POS
انا ابو عدوله هذا لو قدامي صدق اني راح العن ابو من جابه	NEG
انا احب هذا الكاتب	POS
انا اخدت قرار وبعدت عن معصيه لله وقدرت وربي وفقني	POS
انا اردني بقول الشعب بيستاهل غلا اكثر من هيك	NEG
انا اشوفه انه عادي ولا فيه اي معنى وايش مليوني مشاهد والله انه ما يستحق الى هذا الحد من المشاهده وبعدين هاض شي مقزز	NEG
انا اقدر الاخلاص الوفاء بشكل كبير	POS
انا الوحيده الي احس طعم الببسي كنه حديد مصدي	NEG
انا انجنيت	NEG
انا انصح كل انسان ان لايكذب لان الكذب مداه قصير	POS
انا بحب كل الناس بتمنالهم الخير	POS
انا بدات اتحرك شاركت بفكره ستغير الكثير من واقعن	POS
انا بكرهك	NEG
"انا توجيهي سعودي و بدرس بجامعه من احسن جامعات الاردن ، و الشعب قاعد يعيد توجيهي و يرسب من ورى الوزير "	NEG
انا حاسه انه قلبى مليان وعامر بنور الله	POS
انا خلينى ساكته احسن	NEG
انا دايما فرحان مش سائل بالدنيا الحمد لله	POS
انا دمرت انا دمرت مستقبلي ضاع وما معي اكل خبز شو هالحياه شو هالقرف مش حياه الحياه كلها ظلم ما في شغل الاردن	NEG
انا شوفت وقاحه بس زاي وقاحه الاخوان ما شوفت	NEG
انا ضد النووي كالاردن البحث عن مصادر للطاقه النظيفه خصوصا اننا نفتقر للماء و الاجدى بنا ايضا ان نبحث عن سبل لحل مشكله المياه بالمبالغ التي ستصرف على المفاعلات النوويه	NEG
انا عرف شيء والله ببكي اكتر ما بضحك	NEG
انا علي ثقه اني استطيع فعل اي شئ لاني انا من صنع الله	POS
انا فعلا عملت كده والحمدلله بقيت احسن من غير الحجات الي ربنا خدها مني الحمدلله	POS
انا فعلا قررت واخدت القرار ده وحاسه براحه وسعاده كبيره اوي بقربي من ربنا بجد الحمد لله	POS
انا فعلا مؤمن بالفكره دي جدا وبحاول انفذها	POS
انا كل يوم اقول غدا سوف اصلي لكن لا اقدر انا ادعوا الله دائما ان يهديني ارجو من من يملك حل مراسلتي	POS
انا لا احلم ان اغير العالم ولكن احلم بان استطيع ان ارسم البسمه علي وجوه الاخرين	POS
انا لاحظت اللبنانيين انهم ماعندهم روح الكوميديا نهائيا	NEG
انا لله انا اليه راجعون الله يستر هالبلد	NEG
انا لو مكان راغب اروح انتحرر	NEG
انا مِا اغيب الا اذا كرهّت اني ابقى راجع افعالك قبل كُل حاجه	NEG
انا متاكده انو هذولي مدفوعلهم علشان يجون يغنون لانو مافي ناس مهابيل لهالدرجه	NEG
انا متشائم رح اضل متشائم حتى ينزلوا البنزين	NEG
انا مش مسؤول عن الحراميه يتفنجرو بمصاري البلد انا اشحد	NEG
انا مع الاخ محمد سلامه بهالموضوع	NEG
انا معك بان دين الاسلام لكل الناس وفي كل زمان ومكان	POS
انبسط يا عم افرح	POS
انت ما تستحي تقارن القران بوحده ساقطه انعل ابوك لا ابو الملحد	NEG
انت ما شفت النسخه الاوروبيه والامريكيه والماليزيه من نفس البرنامج فيها بلاوي اكثر من كذا بس حنا العرب فينا عقده النقص والتخلف	NEG
انت مو انت انت جوعان كل شوكولاته افرح	POS
انت واحد حقير	NEG
انت واحد عنجد قليل ادب الله يموت الي امثالك	NEG
انت واحد ما بتستا هل الجزمه	NEG
انت يا دكتور خير اخ ربنا يزور عليك	POS
انتخب مين يا عم هى ناقصه لبخه فى الكلام معتش الا الاهبل ده كمان يبقى رئيس جمهوريه	NEG
انتم يا قطريه شن عارفكم السياسه انتم لاعندكم جيش ولا استراتجيه ثابته انتم عملاء امريكا يا خونه	NEG
انته جميل جدا ربنا يثبتك واتمني ان كل المسلمين تكون اخلاقياتهم في حياتهم العاديه قدوه ودعوه لكل غير المسلمين	POS
انته والمعك كلهم سافلين ووقحين	NEG
انتو كلاب ازى تسو المصحف بى كلابه زى ده	NEG
انتي عنجد بنت فاشله	NEG
اندهش لما عرف الحقيقه	NEG
انسان غريب	NEG
انشاء الله نكون راضين بقضاء الله لكننا نرجو من الله اللطف فيه	POS
انشاء الله هنعمل حاجه تفتخرو فيها	POS
انشالله انو يطلع كلام فاضي لانو اذا ضربت سوريا الاردن رح اتصير حرب عالميه ثالثه وما رح اتخلص غير لما نتخزق	NEG
انما المؤمنون اخوه فاصلحو ذات البين	POS
انما بعثت لاتم مكارم الاخلاق	POS
اننا نعيش في زمن بلا رحمه	NEG
انني كومه من القلق والرجفه اكثر من كوني انسان	NEG
انه دين يسر وليس بدين عسر	POS
انه غير مسلم ويعرف قلبه الوفاء فكيف حال المسلمين اللهم ارزق بنات المسلمين زوجا طيبا محبا مثله	POS
اني احبك في الله	POS
اه لو لا القران لقلت ان انكر الاصوات لهذه الاصوات	NEG
اه يا ابو القمل	NEG
اه ياشويه عاهات	NEG
اهل العقول براحه ام نسيانك يابو نسيان صعب والله صعب	NEG
اهلا بك في دين الحق والسلام	POS
اهلا بيك فى دين الله ربنا يثبتك ويزيدك ايمانا انا فرحانه بيك كتير	POS
اهلا وسهلا بشخصك الكريم	POS
اهلا وسهلا بك بيننا يا طارق	POS
اهم اشي اكون مبسوط	POS
اهم شي الواسطه والمظهر الخارجي	NEG
اهما ودهم يروحون النار لكن النار مارضت فيهم	NEG
اوسخ شي المناديل	NEG
اوغاد باعو البلد	NEG
اوقف القرار للحفاظ على الوطن	NEG
اول واحد ذكرنى بصاحب اسمه قرده	NEG
اي الله صحيح اهم شي الانسان كرامته	POS
اي تفائل هاد يا زلمه روح تشائم احسلك	NEG
اي تقدم اي ازدهار مفاعل النوويه بعمل الامراض كثير اهم السرطان الله يبعده عنها انا معهم رفض المفاعل النوويه	NEG
اي والله سوبر	NEG
ايس شراع القرف	NEG
اين ذهبوا العلماء والمخترعين والمفكرين جرب في جرب	NEG
ايه الاحساس الراقى 	POS
ايه الهبل دا	NEG
ايه راحه فيها المسكين ياحرام	NEG
ايها الصغار المتناكفون انكم مع كل منشور ضد بعضكم البعض تصغرون اكثر مما انتم صغار فلا يسلك هذا الطريق الا صغير ساذج يحب ان يعيش على القذارات	NEG
ايوه هيك بدنا ياكم يا شباب بترفعو الراس	POS
باذن الله بديت ولو مؤخرا بنفسى الحمد لله	POS
بارد ومصقع	NEG
بارك الله في دين الاسلم	POS
بارك الله في كاتبها	POS
بارك الله فيك انا نضال فدعولي بزوجه صالحه	POS
بارك الله فيك نتمنى المزيد من النصائح	POS
بارك الله لكما وبارك عليكما وجمع بينكما على خير	POS
بالله تسكتوا خلينا بحالنا بدناش مشاكل ايه	NEG
بالله عليك فين الاناقه في الناس اللي بتغني دي	NEG
باللـــه عليكم الم تستحيوا من انفسكم قبل قدومكم الى هذا البرنامج ثم الم تعلموا ان هناك مسابقات لانكر الاصوات في قناه اخرى	NEG
بالله يا شباب وش رايكم بالاشكال هذه هل تتوقعون اهلهم كارهينهم والناس تجي لاهاليهم وتقول لهم حرام عليكم هذول من دمكم	NEG
"بالمناسبه انا مؤدب جدا ، لا احتسى الكحول ولا ابحث عن علاقات مشبوه"	POS
بتخافى حد ياخد مكانك مع انك مالكيش مكان اصلا 	NEG
بتقول كلام زي الفل	POS
بتمنى لو ان تقوم بعثه للدعاه من مصر تزور جميع البلاد تعرفهم تشرح ما هو الدين الاسلامي تنشر بحق فى كل مكان	POS
بجد ربنا يبارك فى كلماتك بتوصل والله	POS
بجد موضوع رائع وانا اجد انه مناسب ايضا لهذا الوقت يارب احفظنا من جميع الفتن	POS
بدعى على طول بان الله يرزقنى الخشوع	POS
بدك الصراحه بدون زعل جهنم الزبانيه من الملائكه تنتظرك تموت لتشرب من فروج المومسات صديد اهل النار ان شاء الله يا اوباش سوريا	NEG
بدكو تخلونا نشحد	NEG
بدي اروح عمره الله ييسر	POS
برامج سخيفه تهدف لهدم الامه	NEG
برك الله فيك وجعلها في مزان حسناتيك	POS
برلمان المانيا يقر باغلبيه كبيره التخلي عن الطاقه النوويه حتى 2022 الاردن يطرح عطاءلانشاء محطه طاقه نوويه الله لا يطعمنا الحج والناس مروحه	NEG
برنامج ساقط	NEG
برنامج فاشل جدا	NEG
برنامج قديم	NEG
برنامج معوق ومشاركين معوقين:	NEG
بس اكيد وراها مصلحه	NEG
بس الحكام ماعندهم ذوق للاسف	NEG
بس الله لا يسامحكم تلقوها بصحتكم ان شاء الله	NEG
بس اللي قاهرني اللي ما ينطقون حرف الراء التغ من جدهم جايين يبون يغنون	NEG
بس مقزز	NEG
بسعد ربك وصباحك عسل انت وكل من قال انا اردني وبحب القياده الهاشميه وتراب الاردن وسنح الاخوان ولاد كلب على هالصبح	NEG
بسمه امل حلوه	POS
بصفحات الفيزا على جواز السفر حاطين صور اثار الاردن عاساس هيك بس اشوفهم رح احن و ابطل اسافر	NEG
بصمات راقيه لاديب الدعوه محمد الغزالي	POS
بطلت كتير وكل ما اترك والتزم مع ربنا برجع تاني وكل اما ارجع ارجع اكتر من الاول	POS
بطني وجعتني من الضحك	NEG
بعد عقود مرض الكلب واستبشرنا نحن الشعب اخيرا مات الكلب واصبح ابن الكلب رئيسا بالاجماع 	NEG
بعد عن التشاؤم وعيش يومك بالتفاؤل لغد احلى	POS
بعدك ما شفت اشي	NEG
بعدين الاردن تسبح على بحر من النفط الصخر الزيتي اشتغلو فيه بالاول بيكفينا 100 سنه	NEG
بعدين حتى الدول الي اعلنت انهاء المفاعلات النوويه زي اليابان تراجعت عن قراره	NEG
بعرف بس مو حلو	NEG
بعرف حكايات مليانه عاهات مثلكم مجانين يا صيدات جورج وسوف	NEG
بعض الاصدقاء يشبهون المطر في قدرتهم على تعديل المزاج هؤلاء من احتاجهم بقربي	POS
بعن الله ابوك انت وعدوله يالسامج	NEG
بعين الله يا امال كلهن ستين سبعين سنه وبمضن وبتهون	NEG
بقرف زيك	NEG
بقطعكم شو حقودين	NEG
بكتب اوراق الشجر يقول موهبتي وانا صغير الله يسامح اللي كاذب عليه	NEG
بكره واحد منهم بينتحر لم يضحكو عليه	NEG
بلا هم بلا وجع راس خليك رايق دايما	POS
بلد يديرها اغبياء حراميه	NEG
بنحاول فى كل مره نكون افضل	POS
بنص المقطع سقاله موطبيعيه	NEG
بني البرنامج النووي الاردني على عده تصورات خاطئه بشكل خطير تتعلق بالتكنولوجيا	NEG
بوركت جهودك و سلمت اناملك	POS
بياعين شرف	NEG
بيجيبو الشيوخ ليسهز فيهم	NEG
بيه الزناخه	NEG
تابعت هذا الجوال من بدايه صدوره وقبل اقترابه للعالم العربي فعلا يستحق كل هذه الاهميه	NEG
تاثير الغرب مبين على العرب المجانين	NEG
تافهين جدا	NEG
تايم لاين اردني واعي ومثقف لفت انتباه زين الاردن لتغيير محتوى تغريدتها  شكرا لاحترامكم الراي العام في الاردن	POS
تبا لكم	NEG
تبارك الرحمن اللهم زد فينا وبارك لنا يارحم الرحمين	POS
تبتنا ياربن علي دكرك وشكرك حسن الخشوع في صلاتك	POS
تبون تقنعونا انكم تخافون على صحه المدخن وعلشان كذا رفعتوا السعر..بيشترونه ولو ب100 دينار  وبيدخنون ولو بعظم وورق شجر	NEG
تحطم ماتبقى من اطيافي	NEG
تحيه لاهل فلسطين الغاليه	POS
تحيه محبه وسلام 	POS
تخسا هما وكل واحد بشد على يدهم مشكلتو شعب سوري يدعون البراء وهم في قمه النذاله	NEG
تدرون يا جماعه الخير انها بتتعدب والله	NEG
تذكر من كذب يكتب عندا الله كاذب لا اله الا الله اما من يتحرى الصدق يكتب عندا الله صادقا	POS
ترتيب ونظام منقطع النظير في احدى مدارس الاناث بقطاع غزه	POS
تركنا كل شئ من اجل رضا الله اللهم ارضى عنا	POS
ترى هاي فاهمه موضوع الوطنيه غلط ترى مش لحالك اردنيه والله اعلم اذا انك اردنيه اصلا شغل سوالف حصيده	NEG
تسلم انت وافكارك	POS
تسلم صرمايتك	NEG
تضحك كانها مفجوعه من شيئ	NEG
تضرب منك لعدوله	NEG
تعليم الاطفال على الاغاني وعلى الرقص بدل من تعليم القران الكريم بدل من تعليم الدين الله لا يوفقكم	NEG
تغني وهي متقرفه	NEG
تفائلوا بالخير تجدوه اعملوا الصالحات	POS
تفه عليك وع شكلك اول ما نشهرت طلقت زوجها خنزيره	NEG
تفو كس امك حماره	NEG
تقول داخله فيها ترله انحولت مع الاغنيه	NEG
تكالبت عليه الكلاب ولم تسمح له بالبروز بعد البرنامج	NEG
تليفيزيون المستقبل صار سيء للغايه ما ادري ليش	NEG
تم تنفيذ الحكم الي في الرد الاول وتم اعدام اول راس والباقي بالطريق	NEG
تماما اللهم لا تحرمنا الصدق في الكلام	POS
تنظرون لا الشام يقتلون بدم بارد	NEG
توكلت عليك يا الله	POS
تويتر صاير ممل	NEG
تؤلمني باسم الحب	NEG
تيس مابفهم	NEG
ثبتك الله يا استاذي ونصرك	POS
ثقيلين دم كثير	NEG
ثكلتك امك	NEG
جابو المسخره لنفسهم الله لايردهم	NEG
جامعه العلوم والتكنولوجيا الاردنيه افضل من 92.7% من جامعات العالم و 98.2% من جامعات الوطن العربي طبقا لتصنيف ويب	POS
جد اشي بخزي	NEG
جزاك الله خيرا ياستاذ مصطفى على ماتبثه في انفسنا ربنا يكثر من امثالك	POS
جزاك الله كل خير بسمه امل رائعه وشيقه جد	POS
جزاك الله كل خير دكتور عمرو ربنا يتقبل منا منكم سائر الاعمال	POS
جزمتي الا اقولك اسفل جزمتي الثوره في سوريا ما اشعلها الا الوهابيين اللي هم السلفيين	NEG
جسمها حلو ترقص عاريه	NEG
جمال الصفحه من جمالكم رقي اخلاقكم انا متاكد ان صفحتنا ستعجبك فانضم الينا ادعو اصدقائك فنحن نسعد بك بهم	POS
جمهور لا يياس الى اخر ثانيه	POS
جميل جدا	POS
جميله المعاني المجرده التي تنزوي عند التطبيق	POS
جميله اوى اوى اوى يارب الكل يحس معنى الكلام ده	POS
جهنم وباس المصير	NEG
جورج وسوف حلب مو طبيعي	NEG
حالات مرضيه نفسيه مستعصيه لا يستطيع شفائها لا العلم لا الفن	NEG
حاويه زباله بوجهك	NEG
حبيبي شرلبوني يموت شرلبونا انا مدريدي? لكن ماني مغير لعيونه	NEG
حتى بالستايل مقلده الله ياخذ عمره الغبي	NEG
حتى فى التخلف مش فالحين منيح	NEG
حتى نعرف نحل مشكله المجاري بعدين منعمل مفاعلات	NEG
حثاله شباب صايع	NEG
حثاله على حثاله والحثاله انظف منهم	NEG
حرام السخريه من الناس	NEG
حرام تحمل اسم عظيم زي هيك	NEG
حرام عليك كانو بقره بتولد	NEG
حرام عليك ماتشوفه شلون يصارخ كانه مشجع في ملعب	NEG
حرام والله حزنت عليه شو هالموقف الشنع	NEG
حرف الراء مصيبه ريس	NEG
حركه ارحمينا الله يشيلك اقول كيف اخوكي وابوكي راضيين عنك اف عندك ايزي	NEG
حزني كثير والله	NEG
حسبنا الله ايش صاير لشبابنا الحشيش والمخدرات غزتهم الله يهونها ويحفظ شباب وبنات الاردن	NEG
حسبنا الله نعم الوكيل في اناس همهم تجويع الشعب	NEG
حسبنا الله نعم الوكيل فيكم في مجلس النواب الحالي الذي لا يمثل الشعب الاردني فهم غير سائلين عن الشعب يبحثون عن مناصب وزاريه رواتب خياليه بينما المواطن الاردني طفح الكيل معه اصبح لا يطيق الحياه	NEG
حسبي الله عليكم الله بحاسبكم على كل حد بينفتن بسلبكم الله لا يسامحكم	NEG
حسبي الله نعم الوكيل في كل ظالم مفتري الله يعين الشعب	NEG
حسيت كله تمثيل وسخافه غباء	NEG
حطمت كل احلامي البريئه	NEG
"حظ من ينعم بمحبه الصغار قبل الكبار ، لان محبتهم صادقه ومن القلب"	POS
حفظ الله ابناء وبنات الامه جميع	POS
حفظ الله وطننا من المنافقين المتاردنين	NEG
حفظ سور جديده تسميعها فى الصلاه يساعد على التركيز	POS
حقا مزبوط صدقت	POS
"حقيقه العمل التطوعي ، يساعد في القضاء على اوقات الفراغ ، يمنحك خبرات وتجربه جديده"	POS
حقيقى لازم نجمد قلبنا عن اى حاجه غلط	POS
حكي فاضي	NEG
حلمي اكون ممثله افلام دعاره 	NEG
حلمي ان اكون مثل سوشي	POS
حلو الشخص يكون عنده هدف يشتغل عليه لكن الدراسه شئ ضروري	POS
حلو صديق عمري	POS
حلو كلامك عزيزي	POS
حلو...نفس العرطه سمعناها قبل 4سنين...طيب تصرف وسوبديلك اشي يرفع اقتصاد البلد	NEG
حلوه اوى الحمله دي وربنا يارب يكرمك وكل الي بيتبرعو	POS
حلوه قوي يا عمرو لو كل واحد تيقن من هذه القصه لن يوجد حاسد لا ظالم لا متواكل اللهم ارزقنا رزقا حلال طيبا اللهم امين	POS
حلوه وهي ساكته اذا ابتسم كرهت شكلها	NEG
حماك الله من النكد	POS
حينما ننجح فى الانتصار على انفسنا	POS
حيوان وكلب الله يموتك	NEG
"خبار الموت تهز قلوبنا بعمق وسياتي اليوم الذي تهتز فيه قلوب من حولنا لموتنا ، يارب نسالك حُسن الختام ورضاك عنا"	POS
خبر عاجل يمنع لجميع المجانين التقدم الى سوبر ستار	NEG
خبل معوق	NEG
خت قرار كتير وبرجع تاني بحاول اتغير ومش عرفه	POS
خراي على احسن علوي ومحب لهاجحش خربت سوريه ياكلب	NEG
خرى عليك	NEG
خساره فيك اسمك :	NEG
خسئو وخسئ امثالهم ومن طاوعهم	NEG
خفي علينا يا حجه بلا مانسمع صوتك الناعم ويصيبنا صرع	NEG
خلتنى اضحك رغم انى مكتئبه جدا	POS
خلق الايثار	POS
خليه يرفع لكن اللي عنده وطنيه انتماء يصف سيارته بالشارع يروح على الشغل مشي	NEG
خير الكلام ما قل دل	POS
خير صديق في الزمان كتاب	POS
دار الزمن وصار الوسط الفني كله نفس ذي العاهات ووضحكو هما علينا	NEG
دائما تبعث النشاط الحيويه في النفوس مع كل صباح اسعد الله صباحك	POS
دخيل عينك يادكتور كلامك ذهب	POS
دربي زدني ثقتا بك فانه لايخيب من وثق بك	POS
دعاء جميل ماشاء الله	POS
دعواتك لنا يا شيخ سلمان بالتوفيق الفلاح الظفر حسن الخاتمه	POS
دعوه اخاك بظهر الغيب لا ترد	POS
دعوه المؤمن لاخيه بظهر الغيب اسرع من البرق	POS
دلوعه حيوانه?	NEG
دمرني النصاني هودعيك يربي بطني	NEG
دمك ثقيل	NEG
ده عمله نادره الاخلاق ملهاش علاقه بالدين	POS
دي اخلاق السلف الصالح	POS
رائع ولاجمل ?حب ربنا	POS
رائعين يا مصريين	POS
رب فعل صغير يستعظمه غيرك خاصه ان كنت تمثل الاسلام	POS
رب كريم	POS
ربك دايما جنبك لو ناديتوا ها تلاقه	POS
ربك دايما جنبك لو نديته هتلاقيه	POS
"ربما تنام وعشرات الدعوات ترفع لك، من فقير اعنته او جائع اطعمته، او حزين اسعدته اومكروب نفست عنه، فلا تستهن بفعل الخير"	POS
ربنا اجعلنا من الصالحين اهدنا الي الريق المستقيم	POS
ربنا اصلح احوالنا	POS
ربنا المستعان ادعولنا ارجوكم	POS
ربنا لا تزغ قلوبنا بعد ان هديتنا	POS
ربنا يبارك فيه يكون قدوه للجميع المسلمين فى انحاء العالم	POS
ربنا يباركلك يا استاذي يعزك	POS
ربنا يتوب علينا من المعاصى	POS
ربنا يثبته	POS
ربنا يحمى الاسلام والمسلمين	POS
ربنا يستر واخلاق المتاسلمين لا ترجعه مره اخرى	POS
ربنا يسهل	POS
ربنا يشفيهم	POS
ربنا يصلح احوالنا يا رب ظاهرا باطن	POS
ربنا يصلح حالنا جميعا	POS
ربنا يعنا علي كل شيء	POS
ربنا يعيننا علي نفسنا	POS
ربنا يقدرنى ويعفو عنى	POS
ربنا يقوي ايمانك	POS
ربنا يقويكى على اخد القرار الصح واحسنى الظن بالله وتوكلى عليه وربنا يقويكى على ضعفك يارب ويعدك عن الغلط ده	POS
ربنا يقوينا ويقدرنا	POS
ربنا يكتر من امثالك يا مصطفى	POS
ربنا يكرمك على سعيك وحُبك للمُساعده	POS
ربنا يكرمك يا دكتور	POS
ربنا يكفينا هذا الشر	POS
ربنا يهدينا يهدي بينا امه محمد الغافلين	POS
ربنا يهديني ويجعلني من الخاشعين والمسلمين اجمعين	POS
ربنا يوفق الجميع علي الخشوع	POS
ربنايحفظك ياشيخ	POS
ربنايقويك اتشجعي وخوذي قرار وخلي الصحبه الصلحه جنبيك	POS
ربى يزيدن ايمان وتقه يارب	POS
ربي ارزقني حلو الحياه و جمال الحظ و سعه الرزق و راحه البال	POS
ربي اشرح لي صدري و احلل عقده من لساني	POS
ربي يكون بالعون ياخي فقد احزنني كلامك	NEG
ربي ينعم علينا بنعمه الخشوع	POS
ربي يهديهن	POS
رجعتولنا الفرحه اللي نسيناها	POS
رح اجتهد باني اكون حلوه يوم عرسي مش اكون مثل القرده	NEG
رحمه الله رحمه واسعه واسكنه فسيح جناته .. نعم الدكتور ونعم الداعيه ونعم الاب ونعم الصديق .... مخلص في عمله ... صدوق في دعوته	POS
رضيت بالله ربا وبالاسلام دينا وبمحمد صلى الله عليه وسلم نبيا ورسولا	POS
رعب وخوف على وجهك ياجبان	NEG
"رغم انني اول من اثار فضيحه في المناهج المقرره في الاردن طوال عقود مضت ، و عوقبت بالفصل عده مرات من التربيه"	NEG
ركز في الاجابه وقول يارب وخد قرار	POS
رهيب حسن تعالى تعالى	NEG
روح اكتب اشي زي العالم الناس بدل ما انت بتتهبل هيك بتتمسخر يا مسخره	NEG
روح موت وانتحر	NEG
روعه الاشياء تبقى روائحها بقى اصحابها ام انصرفوا	POS
ريحتك طلعت	NEG
رئيس مو عارف يحكي حرف الاس روح تخيب ولك يلعنها انيسه على هيك جحش خلفتو	NEG
زاكى اكيد رهف بكفى انه من مشتقات الحليب	POS
زمان المطربيين اللى غنو لهم المعاتيه دول ولعو فى مقابرهم وبيعيطو بدل الدموع دم على تراثهم اللى راح	NEG
زنخه زيك	NEG
زهايمر وخرف وحبتين كبتاجون	NEG
سابقى رائعا معك الى النهايه ان بقيتي رائعه معي الى النهايه	POS
ساترك حبك ليس كرها فيك ولكن لكثره الشركاء فيه	POS
ساعات اللى فى السر هو اللى بيخلى الناس تحبك فى العلن من غير ما يكونوا عارفين الا انهم بيحبوك من غير سبب	POS
"ساعد نفسك بنفسك حتى تجد الطريق المناسب الذي تريده، اكتشف قدراتك واستغل مواهبك ولا تترك نفسك لحيث تاخذك الرياح فينتهي العمر قبل ان تحقق حلمك!"	POS
سافل و غشاش	NEG
سالت اصحابي ف هذا المجال و حكولي غير هيك.الموضوع مكلف. الكل باكد انه الحل لوضع الاردن الحرج هو طاقه نوويه	NEG
سبحان الله اللهم ارزقنا الطمانينه اليقين	POS
سبحان الله ان الله يرزق الدوده في جوف البحر	POS
سبحان الله بحمده عدد خلقه رضى نفسه زنه عرشه مداد كلماته	POS
سبحان الله خالق السماوات الارض	POS
سبحان الله قادر على كل شىء	POS
سبحان الله له فى خلقه شؤون	POS
سبحان الله مالك السموات الارض	POS
سبحان الله مواقف لها معنى قيمه فعلا تعلم ما شاء الله	POS
سبحانك ربنا الواحد الاحد لا شريك لك تحيي تميت انت على كل شيء قدير صلى الله سلم على نبينا محمد على اله صحبه اجمعين	POS
سبحانك ربي اني كنت من الضالمين	POS
سبحانه يهدي من يشاء لا اله الا الله محمد رسول الله	POS
ستجد مساعده الله وعونه لك عندما تكن النيه صادقه	POS
ستضافتهم وعاملتهم معامله انسانيه ولم تحصرهم في مخيمات تفتقر لادنى مطلوبات الحياه مثل الاردن	POS
سخافات وتخلف شباب وصبايا هل الايام	NEG
سخافه الشاميين ابدا ما ينفع لهم الكوميديا	NEG
سخافه بكل ماتحوي الكلمه من معنى	NEG
سخافه مالها حدود	NEG
سخيف مره يمسخرون الواحد ومافي شي يضحك اصلا	NEG
سخيفه قوووه	NEG
سعادتنا تكون بحسن الاستمتاع بالاشياء التي نحصل  عليها كما تكون بحسن الاستغناء عن الاشياء التي نُحرم منها	POS
سلامٌ عليكم طبتم تُقال للطيبين عندما يساقون للجنه وهم من طابت اقوالهم وافعالهم في الدنيا . اللهم اجعلنا منهم..	POS
سلطان القرف	NEG
سلمت امري ربي عالمين رغم البعد احس ان ربنا رح يكتب ويجمعنا ويكون نصيبي	POS
سلمت سلمت يداك انها الاخلاق الكريمه التي علمنا اياها رسولنا الاعظم صلوات الله سلامه عليه اننا انشاء الله سنفعل ما بوسعنا حتى نرسم صوره راقيه جميله عن ديننا اخلاقنا الله المستعان	POS
سلمت يداك روعه	POS
سلمت يمناك كلام من ذهب	POS
سلوا الله الجنه والحوا عليه في طلبها ييسر لكم اسباب دخولها فكل نعيم دونها شقاء وكل فوز دونها خسار فمن زحزح عن النار وادخل الجنه فقد فاز 	POS
سماجه سماجه ووالله البنانيين دمهم ثقيل مره	NEG
سنبقى دائما معا نشاطر بَعضنا البعض مر الحياه وحلوها	POS
سنبقى نذكر دوله الشهيد وصفي التل الذي كان رئيسا للوزراء حبيبا للفقراء	NEG
سوبر حمار والله هذا السوبر حما سبب في تخلفنا	NEG
سوبر سطار ولا بلاش	NEG
سوبر طقاع اول واحد جايته زبيريه	NEG
سوريا تعرضت لمؤامره والامر المحزن ان ولاد سوريا انزلقو فالمؤامره هاذي والشنيعه	NEG
سيئ جدا	NEG
شاهد تحرش جماعي بسيده تحمل طفلها على كورنيش	NEG
شباب صايع مو ملاقي ياكل مخه فاضي متخلف عقليا	NEG
شبابنا زي الورده بس بدهم حدا يدعمهم	POS
شبابنا فيهم الخير بس بدهم حدا يرشدهم	POS
شخصيه تافه	NEG
شردو اطفلها وقتلوا رجالها	NEG
شعب سخيف	NEG
شعب لا يحركه هذا الظلم التعدي على كرامته هو شعب لا يستحق الحياه	NEG
شعوب تافهه همها الحياه الدنيا فكروا في نهايتكم	NEG
شعور الانفصام تاع سنه خامسه كثير بخزي! اللي هو انك عملت كل شي ممكن ينعمل بالجامعه فزهقت وبدك تتخرج بس بنفس الوقت مش هاين عليك تترك الجامعه	NEG
شغل مشغول قرف يع	NEG
شفتها اقول وشذا الكيك	NEG
شكرا دكتور فكلماتك لها بالغ الاثر في نفوسنا	POS
"شكرا لجميل اثراءك المعرفي، كلامك وسلاستك في ايصال المعلومه جميله للغايه"	POS
شكرا لك	POS
شكرا للنجمه الراقيه كنزه اخبار النجوم	POS
شكلك احول موب حوله	NEG
شكلك دايما متاخره عن المدرسه	NEG
شكلو عمرو ماشاف كاميرا تصورو	NEG
شنو السالفه يعني اتقارنون القران الكريم ويه نجوه كرم هاي العرمه لا الله الا الله	NEG
شو الاشي الي بيضحك ما ازنخك	NEG
شو الي جنني و نزلت ماده اثار الاردن	NEG
شو بالا يا دانيا المشكله مش عارفه تكتب هعهعه	NEG
شو عاجبك فيها مثلا ؟ لتكون سيارتكم	NEG
شو عادي يزم انتا ما عندك دم ونخوه يزم انتا مش بني ادم ترى ورح طير	NEG
شو نوع الحشيش ؟؟	NEG
شو هاد البرنامج معقول عرضوه على القنوات	NEG
شو هاض المنشور الوسخ	NEG
شو هالافكار الجهنميه	NEG
شو هالغباء فضحتنا	NEG
شو هالمنشور الوسخ	NEG
شو هل الاهبل	NEG
شو هيدا دلع اخر زمن	NEG
شو يعني بدك ايانا نحكي من وراكي مش حلوه	NEG
شوف شكلك بالاول بعدين احكي	NEG
شي مؤكد انك حمار	NEG
شيئ مؤسف الله يهديه	NEG
صادقه وفنانه من الزمن الجميل والفن اخلاق واحساسها يدرس	POS
صار بدها بطاريه التقوى شحن	POS
صار عناد وكره قله ادب بس ظلموها	NEG
صباح الابتسامه مرسومه على محياك ربي اجعل حياتي حياه احبتي نور على نور	POS
صباح الاماني الجميله المحققه باذن الله	POS
صباح الاماني المحققه باذن الله	POS
صباح الامتحانات	NEG
صباح التفكر	POS
صباح الحب من الله علينا جميعا	POS
صباح الحريه والنصر	POS
صباح الخير الاشراق الامل	POS
صباح الخير لك ياشيخ لكم كلماتك دائما تشعرني بالامان والسكينه والرضي بما كتب الله	POS
صباح الخير والسعاده لكم	POS
صباح الخير والفل	POS
صباح الخيرات والعبادات	POS
صباح الدرب للجنه	POS
صباح الدرب للجنه و بلبل شادي بفنه و ريحه الياس و الحنه	POS
صباح الدرب للجنه وبلبل شادى بفنه وريحه الياس والحنه اقولها لكل احبابي اللهم اجعلنا ممن يتمتعون بروح وريحان وجنه النعيم من الرحمن	POS
صباح الرحمه و البركات ان شاء الله	POS
صباح الزنبق والفل والياسمين	POS
صباح السعاده العامره	POS
صباح العسل	POS
صباح العفو والتسامح صباح الخير لوجه الخير	POS
صباح الفل الورد يا شيخ سلمان عطر الله صباحك بذكره شكره حسن عبادته	POS
صباح القشطه	POS
صباح النور السرور الورد المنثور	POS
صباح الهمه النشاط شيخنا الفاضل	POS
صباح الوجه الصبوح	POS
صباح الورد الجوري الحمر والخمري	POS
صباح الورد لوجه طيبه	POS
صباح الورد والفل	POS
صباح الوفاء لك يا صديقي	POS
صباح كل جميل في هذا الكون	POS
صباح ملؤه الحب العرفان	POS
صباح ملؤه الخيرات المسرات	POS
صباح مملوء بالخير لجميع المسلمين يا رب	POS
صباحات الانوار	POS
صباحات العقول اليقظه الهمم الحييه المتوثبه	POS
صباحات النقاء الابتسامات الصافيه من القلب	POS
صباحك جمال روعه	POS
صباحك خير يا دكتور سلمان	POS
صباحك سعيد	POS
صباحك طيب كطيب المسك العنبر	POS
صباحك مبروك عدوك مهلوك	POS
صباحك نور	POS
صباحك ورد ياسمين معطرين بنسمات من الجنه يا شيخنا الجليل حفظك الله من كل سوء نحبك في الله	POS
صباحكم امل مشرق عطا متجدد كما شروق الشمس	POS
صباحكم تفائل	POS
صباحكم سعاده وعباده مقبوله ان شاء الله	POS
صباحكم ضحكه قلب يملاه الرضى اضحك ياحبيب الملايين	POS
صباحكـم نقاء يشبه سيرتك	POS
"صباحكم هلا و شوق و غلا ،، صباحكم نور و فرح و سرور،، صباحكم ذوق و قدركم فوق ،؛ صباحكم حب وسعاده"	POS
صبح يحكي للتلفزيون الاردني العقار في الاردن رخيص ! وجميل ... رخيص يعني بنقدر نملك شقه ب 10000	NEG
صبحك الله بالخير	POS
صبحكم الله ياهل الطيب بالخير يسعد ضحاكم الظهر العشيه	POS
صح الابتسامه تصنع السعاده	POS
صح الصح كمان	POS
صح علشان كده منكذبش ونرتاح	POS
صح كلامك احلى حكمه محد يبقى للنهايه رغم اتفاق الطرفين	POS
صح لسانك	POS
صح يا اخي صدقت الله يعين الجميع	POS
صحح الخبر مش تحرير المشتقات النفطيه انما توليعها	NEG
صحيح الابتسامه لها تعابير كثيره	POS
صحيح انك سافل	NEG
صحيح كل هالشغله بس قرار وبظن كلنا قادرين ناخده اذا استعنا وتوكلنا الله	POS
صدقت الله يا شيخ	POS
صدقت والله انت تريد وانا اريد والله يفعل ما يريد	POS
صدقت يا استاذ عمر	POS
صدقت يا رب اجعلنا راضين بقدرك	POS
صدقتي رائعه معبره الكلام	POS
صراحه الاراده القناعه هيا الغنى الاكتفاء	POS
صراحه بخزي من دون مجامله	NEG
صراع متصاعد للهيمنه على سوق الالمنيوم العالميه	NEG
صرفات تجعلك زوجه نكديه بجداره	NEG
صرماتي براس اهلك	NEG
صلوا علي من بكي شوقا لرؤيتنا	POS
صوتك وحش	NEG
صوته مره منبح احسه تعبان عاد زبدوله مابقى الا يطلع بعد شوي	NEG
صوتها بعيرَ ومصدقه حالها	NEG
صور جميله	POS
"صوره مليانه روح ، يعلم الله اني سعيد جدا فيها ففيها شباب حافظين لكتاب الله"	POS
ضحكت طفل بسمه امل 	POS
ضع امنياتكم في سجده انساها وتاكد ان الله لن ينساها ابدا	POS
ضيعت دقايق من عمري بمشاهده ازنخ اتفه شخص بالحياه الا هو اللي بالنص لا حتى بعرف اسمه	NEG
طالما انك تتوجه الى الله عز وجل باستمرار فلسوف يفتح عليك اكثر مما تتخيل	POS
طبعا اكيد والف	POS
طبعا محدش يقدر بس سبحان الله فيه ناس عايشين من غير مياه	POS
طبعا واقع	POS
طبيب عيون اردني يسجل اختراعا جديدا في روسيا. كل يوم انجاز اردني يسجل.  اﻻردن تكبر بابنائها 	POS
طريق واحد عدم اليئس هو طريق النجاح	POS
طلعوا العرب اخس واخس واخس	NEG
طموح الانسان يدفه لتحقيق اهدافه يا رت شببنا ما يقولن فات الوقت الله يوفق من يشاء	POS
طول عمر بخاف ان امثالك يصبحوا مطربين	NEG
طول عمرك تخاف من الحب 	NEG
طيب الله انفاسك وياسلام لو الشباب او الشابات اذا احبو يحبون كجب شاه جاهان وممتاز محل	POS
طيب انا عايزه اشوف القصر	POS
طيب ليه السخريه دى ماكنا كويسين	NEG
ظني بالله جميل	POS
عادي محنا اتعودنا على الرفع من يوم يومنا نحن ما بنعرف غير الرفع همه برفعو نحنا بندفع على حسابنا	NEG
عالم فاضيه بيسمو الغناء فن بيشغلو الناس	NEG
عاهات العرب الجرب	NEG
عاهات اللهم لاشماته	NEG
عاهات وعهد الله عاهات ايه اللي خلاهم يغنو دول	NEG
عاهاتك يا وطنعاهاتك يا وطن	NEG
عاهاتك يا وطني	NEG
عاهاتك ياعرب	NEG
عجبتنى الحلقه	POS
عجل يا الله	POS
عد دراسه قمنا بها تبين ان وضع خلايه شمسيه في صجراء الاردن والسعوده تكفي للاناره الارض كامله مدى الحياه	POS
عدوله السامج هذا خرب اوم المقطع قسسم زباله هالادمي ودمه زززفت انا ضحكت	NEG
عذبت ام العود	NEG
عرب اغبياء	NEG
عــرب جـــرب	NEG
عشان هيك قال النبي صلى الله عليه وسلم ان الكذب يهدي الى الفجور والفجور يهدي الى النار	POS
عطله 15 يوم وكمان اسبوع عطله و 20 دينار لكل طالب هاي مدرسه ولا شهر عسل	NEG
عظيم هو اسلامنا 	POS
عفكره البيج هاد قرفني وقلب معدتي شو للاسف انتا انو عرفك انه هيك الوضع بتفتح بالفنجان يا ناس خفوا علينا الدين مش للايكات وكمنتات	NEG
على الاقل هناك رجل وفي لامراه احبها وهذا يسعدني	POS
على فكره المعلقين هدول ولاد حرام	NEG
عليا النعمه ابدا لا هو ولا الخروف التاني	NEG
عليك بتقوى الله ان كنت غافلا	POS
عليكم بالدعاء والتضرع لله سبحانه وتعالى ولا يرد القضاء اللا الدعاء اجتهدوا رحمكم الله	POS
عمدا فيهم ما نستعمل التدفئه نلبس فروه	NEG
عمرتنا كانت مميزه جدا ورائعه	POS
عمل السريره هو العمل الخالص لله اللهم ارزقنا عمل السريره	POS
عن جد انتى ما شاء الله عليكى جزاكى الله كل خير	POS
عنجد الكذب اكبر ورطه	POS
عنجد انو باله	NEG
عنجد بخزي	NEG
عنجد بخزي شو هاد على حساب ازياء طلع باله	NEG
عنجد هذا الانسان تافه وحقير	NEG
عندك حق انت امل جميل مشرق	POS
عندما يقدم طلاب على حرق الكتب المدرسيه والاضراب فنحن نعيش انتكاسه في التعليم بطلها المعلم الغير مبالي الذين اججوا وافتعلوا الازمه	NEG
"عندما يقول لك احد:  ابشرك فانك مباشره تفرح وتبتسم فكيف اذا كان القائل هو الله سبحانه وتعالى حين يقول : ""وبشر الصابرين"""	POS
عني كل يعلقو الا انا	NEG
عوام الشيعه بين ساذج ومغفل وجاهل ومتجاهل ولا يمكن لعاقل ان يظن ان عباده الله تكون بان تقضي حياتك بين لطم ولعن وتباكي	NEG
عيب عليك ماتستحي	NEG
عيب عليكوا تقارنوا وحده زى دى بالمصحف الى هوا كلام ربنا	NEG
عيب والله اسم المقطع	NEG
عيب يغني ده السادات وده ابن مره	NEG
عيش زي ما بدك ما ترد على حدا ابدا	POS
عين العقل ربي	POS
غباء في غباء لان نفس الحركه صارت في  يعني قلدنه البرنامج وبعد التصرفات اوووف	NEG
غبي الله يزيد غباك	NEG
غبي انتا اشي الصووووت هاد بتشبهو بجورج وسوف	NEG
غبي من جده	NEG
غرباء نحن حتي في احلامنا نعيش واقع ليس لنا فيه نصيب. .؟ نتمني اشياء كثيره لكن بدون ان نتحمل اي مسؤوليه. ....ننظر الى انفسنا فقط	NEG
غيب عن وجهي	NEG
فاجعل اللهم عوضي فيه	POS
فاشل فاشله برنامج فاشل	NEG
فاشله من بيئه فاشله	NEG
فاشلين الى ما لا نهايه	NEG
فاضل قلمين نخلص	NEG
فاظفر بذات الدين تربت يداك	POS
فاقد لكل معاني الاحساس	NEG
فالاول يصحح مساري الثاني يزيد من اصراري	POS
فانا اناشد الحكومه الاردنيه بالافراج عن اسرى السلفيين التوحيدين الموجودين في سجونهم	NEG
فاهجر تجد عوضا عما تفارقه	POS
فتاه تحاول استعراض جسدها	NEG
فتحه نصره نوره بركته هداه	POS
فدمك عود مع عنبر	POS
فشرت عين الشيعه والله بنحرقهم حر	NEG
فشرت عينك	NEG
فشلوه مره صدق انهم دلوخ	NEG
فضحتونا من وين نحنا بال 48 عنا برامج هيك تافها ومخمج	NEG
فطست ضحك على الشايب	NEG
فعلا احس في نفسي دللك	POS
فعلا البت جده لما تحتاج ليه هو الانسان الصادق هو البستاهل تضحي عشان	POS
فعلا الطاقه الشمسيه هي البديل ليست النوويه لان حتى الدول المتقدمه صارت تتخلص من النووي تتجه للطاقه البديله خصوصا نحن الاردن بلد مشمس عالطول السنه الكلفه ما اتوقع اكثر من الطاقه النوويه	NEG
فعلا الله يبعدنا عن الكذب	POS
فعلا الله يجزيك كل الخير دكتور والله يثبتنا على ديننا	POS
فعلا اللي بيســتحوا ماتوا	NEG
فعلا ان الطموح هو سر النجاح	POS
فعلا برنامج ساقط واللي بيتابعه اسقط منه	NEG
فعلا ده صحىح مثلا زى سماع الاغانى التى تلهى عن زكر الله لو تركتها لله ىملا الله قلبك بحبه ولاتشغل بالك الا بذكره	POS
فعلا زي ما حكى اخر شي مهزله وانا مهزله اللي ضيعت وقتي اشوف هيك مسخره فعلا اني مسخره	NEG
فعلا فضايح ما توقعتها في شبابنا المتخلف اخلاقيا وصوتيا وبدنيا اها وعقليا بالتاكيد	NEG
فعلا في البدايه كلهم رائعون	POS
فعلا مهزله	NEG
فعلا والله هو القرار والثبات عليه	POS
فقد عجزت الكلمات	NEG
فلما الحزن فلقد اصبح الحزن صديقي	NEG
فما اجمل هذا الدين	POS
فهم ادرى واخبر لا وبل اكثر انكارا للشيعه وامثالهم	NEG
فوق من اللي انت فيه ربك دايما جمبك لو ناديتو هتلاقيه جايز ده اختبار ركز فالاجابه وقول يارب وخد قرار	POS
فى ناس كتير ربنا كرمهم بنعمه الاسلام ولكنها لا تدرك قيمتها	POS
في ايه يا ولاد الوثخه؟	NEG
في خطبه وحده رفض شيخ اخواني النووي الاردني و مدح النووي الايراني	NEG
في كل مناحي الحياه التكنولوجيا بديل عن البشر الا في التعليم التكنولوجيا تجعل عمل المعلم .. متعه لا بديلا عنه	POS
فيديو بايخ	NEG
فيروسات بشريه	NEG
قال حكم قال	NEG
قرد زاني ابن حرام انقلع قبح الله صورتك ياخنزير	NEG
قرف شوهاد شي بخزي عنجد	NEG
قرف يعيع	NEG
قرف يقرف اللبنانيين شو تافهين	NEG
قرف يقرفك	NEG
قرفت انتحر عن الدرج	NEG
قريبا ان شاء لله تسمع اخبار تسركم	POS
قصدك اخر ما توصل اليه العقل البشري من تفاهات	NEG
قصه جميله تعلم الناس كمان الامانه لان اذا اخذ القليل اخذا الكثير	POS
قصه جميله جدا تعكس معنى الايمان التمسك بالعقيده الصحيحه حسن تعاليمها	POS
قصه جميله مهمه جدا	POS
قصه جميله ودايما انا بحب اسمع البرنامج	POS
قصه حقيقيه رائعه فيها عبره لكل زوج وزوجه فيها الموده والرحمه	POS
قصه رائعه افادك الله من العلم لتفيدنا دائما	POS
قصه رائعه ياريت كل الرجال هيك	POS
قصه فى منتهى الروعه	POS
قصه في غايه الروعه	POS
قل لي من تصاحب اقول لك من انت	POS
قلت ادب	NEG
قلولهم هذا سوبر ستار مش مسابقه لبياع الخضار	NEG
قمه البلاغه	POS
قمه التخلف البشري الله يشفيهم	NEG
قمه التخلف والانحطاط	NEG
قهروني حرام	NEG
قول يا الله ده عنك مش بعيد متشلش هم ولا تشعر بضيق اقول يالله اهديني ياقلبي عشان اتوب امحي الذنوب واهديلي الطريق	POS
قول يا رب وخد قرار	POS
قول يارب ادعي كتير انك تكره هذه المعصيه وربنا كريم	POS
قولى يارب ثم توكلى عليه انه نعم المولى نعم الوكيل احتسبى عنده ما تظنين انك لا تقدرين عليه	POS
كارثه بشريه	NEG
كافر ملعون جهنم باذن الله	NEG
كاميرا خفيه في الانحطاط الاخلاقي	NEG
"كان خطاي الوحيد، اعطيت من لا يستحق اكثر من حقه"	NEG
"كان نفسي اكون شخص بارد ، يتقبل اي حاجه من غير ما يتاثر."	NEG
كانت الحياه صعبه والمدرسين خشنين واغلبهم من الاردن وفلسطين لكنهم علمونا الادب والعلم غفر الله لامواتهم	POS
"كانت العرب في الجاهليه، يصيبها التشاؤم ان رات رجل او امراه لون عينيه ازرق وكانت تعتقد انهم شياطين او مس شيطاني اصابهم وهم اجنه"	NEG
كانت تسوي مقلب انها محترمه بعدين اعترفت انها	NEG
كانهم خرفان العيد عند المسلخ	NEG
"كباب كباب واخرتها لحم كلاب تكرمون ، احذروا"	NEG
كتكوت ضعيف الجناح الدنيا غدرت ها	NEG
كتير رخيص ومقرف	NEG
كثر الكلام في هذان الموضوعين ولم يتحقق على الواقع شي اصبح المواطن يتبع سراب	NEG
كثر الله من امثالك زادك الله علم	POS
كدا عيب اودني راحت فيها	NEG
كرامتى اولى	POS
كرامتي افضل من سعادتي	POS
"كرهت كلمه نازح، لاجئ، ازمه،  وضع،  توره، تاريخ،  جغرافيا"	NEG
كس اخـتك	NEG
كس امكم يالعرب يابهايم يابقايا حضارات الامم	NEG
كسم البرامج العربيه متخلفه بنت شرموطه	NEG
كسم العته البشرى	NEG
كل الاحترام	POS
"كل البدايات جميله لكن العبره دائما تكون بالختام,اما كسبت او تعلمت درس مستحيل تنساه."	POS
كل النسخ العربيه والاجنبه كله تمثيل في تمثيل مسخره وعقول تاقهه	NEG
كل سنه وانتم طيبين	POS
كل شخص فينا بيتمنى الخشوع في صلاته يا رب يتقبل صلاتنا صيامنا	POS
كل شئ في حب الله تهون وحب ربنا اقوى بكتير من اى حاجه	POS
كل شئ ماله معنى بهالحياه الا الفلوس هي الحياه وهي من تقرر مصير كل شئ بهالدنيا الا شئ واحد الموت لا يتناغم مع الفلوس	POS
كل واحد حرامي ما بهمو مصلحه المسكين المواطن الي بشتغل 14ساعه 6دنانير	NEG
كل يوم اجتماعات ومناقشات وتحليلات ومفاوضات بشان سوريه وكلو حكي فاضي وعلاك مصدي اذا ما في نيه صادقه مخلصه من كل الاطراف لن تنتهي ماساتنا	NEG
كل يوم يصدمنا الاعلام بنتائج رقميه مجهوله المصدر والتوثيق والاستقراء حول التعليم في الاردن لتبرروا تغير المناهج المخزي لا لن تخدعونا	NEG
كلام بليغ اللهم ارزقنا الزوج الصالح من يعرف معني رفقا بالقوارير	POS
كلام جميل	POS
كلام جميل الكرامه افضل ابقى للانسان	POS
كلام جى فى وقته	POS
كلام حقيقي	POS
كلام حلو ومشجع	POS
كلام ذهب	POS
كلام رائع وفي وقته وربنا قادر علي كل شئ	POS
كلام سليم	POS
كلام سليم الف بالميه الله	POS
كلام سليم والصراحه راحه	POS
كلام صحيح من شان هيك الدول اللي ما فيها بطاله والمجتمعات المفتوحه بتقل فيها المشاكل النفسيه	POS
كلام طيب	POS
كلام ما في جدل	POS
كلامك جميل ورائع	POS
كلامك يشعرني بالتفاؤل يمدني بالقوه الاستمرار	POS
كلب واطي	NEG
كلب وحقير	NEG
كلمات رائعه حلوه لا احلى ان يكونو في النهايه رائعون	POS
كلماتك عذبه	POS
كـلمه حب عـجـبـتـنـى جـيـت  اقــؤلها جــرحـتـنـى	NEG
كلنا ما انتصرنا على نفسنا وعلى الحاجه ددي الي متعبتنا ومبعدتنا عن الله	POS
كله على راس المواطن ما يثير السخريه رفع اسعار المستقات النفطيه المستخدمه في الصناعه تقول صناعتنا مكسره الدنيا	NEG
كلهم فاجرين	NEG
كلهم معندهمش احساس	NEG
كلو حكي فاضي	NEG
كم هي ثقيله على لسانك .. فرائحه الدجل والنفاق بنظرات عيونك !! 	NEG
كن انت التغير الذي تريد ان تراه	POS
كن انت ذلك الشخص	POS
كن ايجابيا وتذكر ان قليلا من التفاؤل قد يصنع الف طريق نحو السعاده صباحكم مليان طاقه ايجابيه	POS
كن كما انت لا تتغير من اجل احد	POS
كن مع الله لا تبالي	POS
كنا نقول البلد حاميها حراميها ماذا سنقول الان مفتيها حراميها الله الواحد تحير في هذه الامه التي اصبح الحليم فيها حيران	NEG
كنا نقول عاهات	NEG
كنت اخادع الحياه لكي اعيش كما اريد لكن الحياه خدعتني عشت كما هي تريد	POS
كنت اشوف الاجانب اقول موسوسين	NEG
كيد النساء لولا مكر الرجال لما خلقت حــواء بكيــد عظيــم	NEG
كيف صرت كاتب يا زلمه ؟؟ انت كثير عليك حمار	NEG
كيف لا احبه و في كل مساء يهديني شيئا من روحه 	POS
كيف يجتمع ستر وغض البصر	NEG
لا احنا نتبع نظام مختلط بين الراسماليه والاشتراكيه	POS
لا استطيع اللهم ارزقنا العافيه وشكر نعمتك	POS
لا اله الا الله محمد رسول الله	POS
لا بقلو بيضه حكي فارط نحن الاردنيه ما حد بيطلع معنا براس	NEG
لا تتهاون بحجاب زوجتك  فهناك رجال في الطرقات في قلوبهم مرض يتمتعون بالنظر لنساء	NEG
"لا تحاول لفت انتباه احد , ان لم تكن ملفت بالفطره ستبدو احمقا بالتظاهر"	NEG
لا تحزن الدنيا ما فيها اشي تحزن عليه	POS
لا تحزن ان الله معك	POS
لا تحزن على دنا فانيه بل احزن على اخره باقيه	POS
"لا تخسر قيمتك بكلمه، ولا تفقد احترامك بزله، ولا تجعل همك في الدنيا هو حب الناس لك،فالناس قلوبهم متقلبه قد تحبك اليوم و تكرهك غدا"	POS
لا تعليق	NEG
لا تفهمي غلط حبيبتي	NEG
لا تقنتوا من رحمه الله فهي وسعت كل شيء مهما عصينا فلنا رب كبير رحيم ورحمن	POS
"لا تياسوا من روح الله، الله تعالى لا يعجزه شيء، فكم من مريض شفاه، وكم من فقير اغناه، وكم من مشرف على الهلاك نجاه، وكم من ضال هداه"	POS
لا حول ولا قوه الا بالله اذا اخذ ما اوهب اسقط ما اوجب	NEG
لا حول ولا قوه الا بالله العظيم  لم اكن اعلم ان نسبه ذكاء العرب منخفضه جدا الى هذا الحد	NEG
لا حول ولا قوه الا بالله ليش الحرج هدا	NEG
لا ربنا يرحمنا برحمته	POS
لا شو انا مسخره كلكو خنازير	NEG
لا طبعا التقرب الى الله هو خير علاج للحالات النفسيه	POS
لا عنجد زلمه شكلو بخوف	NEG
لا كرامه في الحب والغرام	POS
لا للمفاعل داخل الاردن	NEG
لا محاله اول شيء يحدث له بعد عودته للمغرب سيتم اغتصابه كالعاهره	NEG
لا مش فاهماك	NEG
لا مو حقودين ولا شي	NEG
لا مو حلو و بخزي	NEG
لا نووي ولا صوبه بواري كالعاده نصبه جديده	NEG
لا هديله بالجزمه طبعا	NEG
لا هديله بالشوز زى الصعيدى الى يكرمه الى ضربه بالشبشب ناقصه حراميه	NEG
لا والله ما بلسه يع	NEG
لا والله ماهم اللي مسخره انا اللي مسخره اللي تفرجت عليهم	NEG
لا وحده مع القران هو انيسي ام الغرام فلا احتاجه مطلقا	POS
لا ياس مع الحياه	POS
لا ياعزيزتي انا عايشه بالمحكمه واشوف تسلط وظلم كبير من اشباه الرجال بس بالنهايه المظلومه تجد من ينتصر لها وبكل هدوء بدون افلام	NEG
لا يشكي قله المال لكنه يشكو امانه الرجال	POS
لا يعني الغبي يدري انه كاتب اسمها بالورقه مايبيلها ذكاء ترى	NEG
لا يغير الله ما بقوم حتى يغيروا ما بانفسهم	POS
لا يوجد كفائات بالاردن قادره على اداره هكذا مشروع	NEG
"لاتتحدث بقوتك امام ضعيف ، و لا بسعادتك امام حزين ، و لا بمالك امام فقير، زن كلامك و راع شعور الاخرين"	NEG
لاتحزن فان الحسنه بعشره امثالها الى سبعمائه ضعف الى اضعاف كثيره و السيئه بمثلها الا ان يعفو ربك يتجاوز فكم لله من كرم ما سمع مثله و من جود لا يقاربه جود	POS
لاتنساني من دعائك الصالح شيخنا	POS
لازم اخر ما توصل اليه العقل البشري من غباء اخوكم حمزه اللهواني من الاردن	NEG
لازم كل واحد فينا يفكر بشكل ايجابي يبعد عنه السلبيات	POS
لازم يحكم عليهم بالسجن	NEG
لالا بس اغلبهم داريين بس يقولها استعباط ورفع ضعط خذها مني	NEG
لان ديانا كرزون البغله الاردنيه لا تستحق ذلك	NEG
لان ما بعتقد انو في هالقد عاهات ما بيعرفوا انو صوتهم نشاز لانو كتيير نشاز وازا في رح تكون حالات استثنائيه مو بهاد الكم الكبير	NEG
لانه النووي ضرره علينا اكتر بكتير من فوائده	NEG
لانهم يمكن يكونو قاهرينك	NEG
لبنان وزبالتوا	NEG
لتصل الى القمه لا تلتفت الى مغريات الطريق	POS
لجنه تافهه	NEG
لجنه حكم ماعندها ذره احترام	NEG
لجنه زباله من اذا بفهمو بالفن خاصه ابو النظارات اللي مش موجود بالفيديو	NEG
لجنه فاشله تتمسخر على المتقدمين	NEG
لدى الاردن مؤهلات عظيمه لاستغلال الطاقه الشمسيه وطاقه الرياح وطاقه باطن الارض والوقود الحيوي. وكلها طاقه امنه ونظيفه ومتجدده.	POS
لست الافضل لكن لي اسلوبي ساظل دائما اتقبل راي الناقد الحاسد	POS
لسنا مجبرين على تبرير المواقف لمن يسىء الظن بنا من يعرفنا جيدا يفهمنا جيدا فالعين تكذب نفسها ان احبّت 	POS
لعن الله المتشبهين من الرجال للنساء	NEG
لعنكم الله جهنم وبئس المصير ايها العازفون	NEG
لقد اتحفتمونا بلجوكم لجيبتنا التي انفجرت بفضلكم الفاسدين يتنعمون باموالنا فهل اصبح فاسدا لاعيش	NEG
لقد اسمعت لو ناديت حيا.. ولكن لا حياه لمن تنادي ولو نارا نفخت بها اضاءت .ولكن انت تنفخ في الرماد 	NEG
لك كلك ذوق حكمه	POS
لكل مجتهد نصيب ... من لديه هدف ويثابر عليه حتما بعد امر الله سوف يصل	POS
لكن للاسف عنا كلمه معاق في الحياه العامه في الاردن تستخدم للتعبير عن الشخص الغبي علشان هيك انا قلت ذوي الاحتياجات الخاصه افضل	NEG
لكن هذا البرنامج السخيف الرخيص واضح التمثيل فيه	NEG
للاسف اصبحنا غرباء في اوطاننا اصبح الوطن وكانه ليس لنا اصبح الوطن ملك خاص لتاجرين والمتنفذين	NEG
للاسف البعض يعتقد ان المفاعل النووي سيحل مشاكلنا الاقتصاديه ولكن الاردن لا يمتلك موارد ماليه وهذا يعني الحاجه لشريك اجنبي كما اعلنت هيئه الطاقه يملك غالبيه الاسهم كما في تركيا على سبيل المثال وذلك يعني ان هذا الشريك سيمتلك الجزء الاكبر من المفاعل ولن يكون ملك للاردن وبالتالي ستقوم الحكومه ايضا بدفع تكاليف الكهرباء للمستثمر وبالتالي المفاعل النووي لن يوفر لك الكهرباء بسعر قليل	NEG
للاسف لسا في مدارس بتخلخل عظام الطلاب من البرد عن مدارس قرى الاْردن و المناطق الشعبيه عّم بحكي	NEG
للبرنامج التافه الي يسمح لهذا الشي	NEG
لله يحرق قلبك يبشار	NEG
للهم اعنا على ادراك هذا المعنى العظيم يا رب	POS
للهم املا قلبي بحبك وحب نبيك وحب كل عمل يقربني الي حبك	POS
للهم خذهم اخد عزيز مقتدر فانهم لا يرحموا الضعفاء اللهم سلط عليهم عذابك فانهم ارونا الويلات	NEG
للي مفكرين المفاعل راح يطورهم المفاعل راح يدمر الاردن المنطقه اللي حولها لان الفساد الموجود بالاردن مش موجود بدوله اخرى هذا يعني ان الفاسدين رايحين يسمسروا يلهفوا لما يوصلوا اشكل مفاعل للاردن ناسين ان المفاعل يحتاج الى بحر ماء للتبريد نحن لانملك ماء للشرب ناسين ان التطور يكون بمشاركه الجميع ليس بقرار فردي ناسين ان الذي اقر المفاعل هو المحتكر الاول هيئه الطاقه ان شاغرها بقي معلق اثناء فتره تسلم طوقان وزاره التربيه والتعليم لدول المتقدمه بدات تبحث عن بدائل للمفاعلات نحن بنشتري الخربان منهم مشان التقدم بلدنا بفضل الله لديها طاقه الرياح طاقه الشمس لماذا لا يتم استغلالها بدل المفاعل النووي طالما اكلنا معظمه فاسد غير صالح بسبب الجشع الطمع الفساد	NEG
لما اجد فيها الا الجراح	NEG
لما تكثر عليا الالتزامات يصير كل اللي نفسي اسويه استلقي على ظهري واسولف للسماء	NEG
لن تموت نفس حتى تستكمل رزقها اجلها	POS
لن يقفل باب مدينتنا فانا ذاهبه لاصلي سادق على الابواب و سافتحها الابواب و ستغسل يا نهر الاردن وجهي بمياه قدسيه و ستمحو يا نهر الاردن اثار القدم الهمجيه	POS
لنفترض جدلا ان لا اضرار صحيه بيئيه سينتج عن بناء مفاعلات نوويه سلميه دعونا نفكر في الكلفه من حيث اولا: كلفه بناء عاليه جدا لعدم امتلاكنا لهذه التكنولوجيا على شكل ديون تثفل كاهل العشر اجيال القادمه  ثانيا: لنفس السبب سنستورد خبراء للتشغيل لسنوات طويله مما يزيد كلفه الطاقه ليس العكس ناهيك عن حصول اي اخطاء مفترضه مستقبلا ثالثا: اين هو المكان البعيد عن المدن في الاردن واين مصدر المياه الكافيه للتبريد رابعا:من حق المواطنين اصحاب القرار الحصول على تقرير منشور للاثر البيئي مسبقا بنفس الوقت نستطيع الحصول على نفس كميه الطاقه من الصخر الزيتي الذي نمتلك منه احتياطي هائل من الغاز الطبيعي المؤمل مستقبلا من الطاقه الشمسيه من طاقه الرياح بكلف نسبيا اقل بكثير من النووي دون اعباء ديون اضافيه	NEG
لهل درجه في متخلفين في الوطن العربي؟؟؟؟؟؟	NEG
لهم صارو يبيعو يشترو في البلد متل ما بدهم	NEG
لو اغلقت الابواب في وجهك واظلمت الدنيا  خنقتك الدموع و ضاقت بك الارض استحضر معنى اسم الله الفتاح القادر سبحانه قادر على فتح ما انغلق من امرك	POS
لو حد يا جماعه يعرف طبيب اذن يدلني ولا شكلي هارميهم خلاص باظو	NEG
لو سمحت لا تقول اخبار مغلوطه ولا ابعطيك انفولو جيب رابط الخبر وبلاش تصرف من راسك	NEG
لو طلعتي من الاردن وين تروحي	NEG
لو كاكا بالبرازيل كنت اعطيط لايك بس هيك فشر	NEG
لو كان للحب رائحه .. لكانت رائحه القهوه في يوم ممطر	POS
لو نريد الخشوع حقا نطلق الدنيا	POS
لو يبطلو سرقه بهالخزينه الله الشعب ليعيش لكو ارحمونا حرام عليكم	NEG
لو يدرس في جامعات مصر او الاردن يعرف الدراسه والعلم الحقيقي وهناك اللي يقدرون نسبته وتفوقه	POS
لو يطلع عليهم  بفضحو عرضهم كلهم	NEG
لوين ندكم توصلونا الله هموم المصاريف قتلت الصغير قبل الكبير الله ياخذ حقنا منكم لا يباركلكم	NEG
لى جماعه الاخوان الخسيسه كيف بدكو الوطن يتصلح وانتو قسمتوه لفريقيين كل واحد منكم اخدنا لمطرح ومش عارفين واصليين لوين	NEG
ليت بعض الذكريات ينعمل لها فورمات 	NEG
ليت كل ايام السنه رمضان	POS
ليتنا نستطيع الابتسامه في الاوقات المؤلمه	POS
ليس هناك شخص معاق بل هناك مجتمع يعيق	NEG
ليش الطلاب فاضين يعملو مشاكل فاضين للدراسه يعني ما عندهم وقت فراغ للمشاكل	NEG
ليش تتضحكو مش حلو	NEG
ليش ما نتعلم من الي صار في اليابان  وروسيا  المانيا الغت نظرتها في بناء مفاعلات نوويه استخدام الطاقه البديله	NEG
ليش محشورين على بعض كذا خلصت الطاولات مالقو الا الطاوله الخايسه	NEG
ليش معصب يا عدوله	NEG
ليش هيك معجبين على الاردني	NEG
ليش يعني اخترت انه مصيره في فتح يا تافه وفي المؤتمر السادس كمان يا ابن الكلب	NEG
ما اثقل دمك ما اغباك	NEG
ما اجمل الاخاء	POS
ما اجمل الحياه برضى الله	POS
ما اجمل الصبر الاصرار	POS
ما اجمل الكلام والاروع ان نطبقه	POS
ما اجمل الوفاء	POS
ما اجمل ديننا الاسلامي	POS
ما اجمل من مثل هذا الحُب الصادق الشفا	NEG
ما احسنهم الله يكون معهم	POS
ما احقر الاصدقاء حينما يصبحون غرباء فجاه	NEG
ما احلى الوجود بقرب الله	POS
ما ارحمك يا ربى بخلقك سبحانك يا حبيبى يا الله	POS
ما اروع برنامج الطريق الى الله	POS
ما اروعهم	POS
ما ازنخ منك الى هاي اللينكات اللي بتسم البدن بتتعب يعني لما توخد الصوره وتنزلها تنزيل عادي	NEG
ما ازنخك انت مقالاتك	NEG
ما اسخفك	NEG
ما اضيق العيش لولا فسحه الامل  الحمد لله	POS
ما اقسى غربه الروح	NEG
ما الزه شكله بشهي بدييييي	POS
ما انا شطبت	NEG
ما بتحبو حد	NEG
ما بدي غير 10 يعملو لايك للبيج	NEG
"ما بقى للسحيجه اشي يسترزقوا منه ،فضائح شركه الولاء وموارد والفوسفات والفساد عادت الى الواجهه ."	NEG
ما بكره حد قدك	NEG
ما حد بيتحكم فيي	NEG
ما سال لله الهادي الخالق	POS
ما شاء الله ... ونعم التعليم في الاردن .... ابدعوا الشباب !!!	POS
ما شاء الله العطله ماثر عليكوا كتير صبايا الكل بحكي حبيبتي وحبي وبلمدرسه كل واحد بكشر من جهه	NEG
ما شاء الله الله يثبتك	POS
ما شاء الله جميله جدا	POS
ما شاء الله على هلتفائل الي عنده	POS
ما شاء الله والله انها امر متل الكرتون	NEG
ما عندهم هو قله احترام للمشتركين وفله ادب تجاه المشاهدين	NEG
ما في احلى من التفائل الواحد بعيش مرتاح	POS
ما في احلى من الفرح	POS
ما في احلى من انه الواحد يوكل وينام	POS
ما في داعي لمصايب جديده للبشر وللبيئه	NEG
ما فيها شك	POS
ما هيك بيقولوا للاسف ما عجبت حدا انت جاهل يا هذا ليس هكذا تدعو الناس لقول لا اله الا الله محمد رسول الله انت غبي يا صاحبل هذا البوست لا تفقه شيئا من العلم الدين انت هيك تبين انك في قمه الجهل العار قل كلاما جيدا محببا لا تتلفظ بالكلام السيئ انما تعجبنا كلنا لو قلت انطقوا بالشهادتين يا اولي الالباب	NEG
ما يستحون هم جايين لو انا منهم اروح اقشر بصل	NEG
مابتحكي معه هيك انزلع لاعاد اشووفك جلطتني	NEG
مات في القريه قردا فاسترحنا من اذاه خلف الملعون عجوزا فاق في الخرف اباه	NEG
ماجمل الحب الاخوه في الله ان نخاف على بعضنا حتى في علاقتنا مع ربنا شئ رائع جدا	POS
ماخاب من دعا الى الله	POS
ماشاء الله عليكم بجد موضوع مهم جدا والاهم الرقي الرائع في الحوار	POS
ماشي هسا انا صرت وله طيب في حدا بيشبهك كتتير	NEG
ماعندك شرف	NEG
مافى اجمل من قوله يارب ومن يتجه الى الله عز وجل لن يتركه الله ابدا	POS
ماكرمك يا ربي يا كريم	POS
ماكل روح الخل	NEG
مالك دين مثل الكلاب الضاله الا اقولك مثل مومسات عاهرات المراقص عندكن	NEG
مالكيش حظ فـي اصحابك ولا اهلك	NEG
مالكيش ف الطيب نصيب	NEG
مايستحون	NEG
مبارك الفوز	POS
مبرد وجوهكم	NEG
مت عليهم حيطه هالانذال اصحاب الاجندات الخاصه الخارجيه العميله	NEG
متخافش يامؤمن قول يارب وحب ربك ده هو اللى خلق النعمه اللى انت متعلق بيها يعنى هو اعظم من النعمه دى وانت عارف كده	POS
متسمم فكره الولد وصارت حالته صعبه يا حنين انت	NEG
متفقين معهم البرنامج خايس	NEG
متهور وكذاب	NEG
متى رح نشوف صحفيين يكشفوا فضائح الفساد وما يخافوا من اي جهه	NEG
متى يجي عام 2050 عشان ادخل رجلي مع الشاشه واحطها بفمك	NEG
مثال جميل جدا عبره لكل من يحمل رساله الاسلام	POS
مثل الاميره من حواليها حرس تمشي دلع و من الترف متعاليه ما كل خيال يروض له فرس مهره اصيله من حلاها غاليه	POS
مجانين احد يضحك عليك وانتم قدامه وتكمل	NEG
مجانين العرب	NEG
مجنون صوتها انا	NEG
محششين خخخخ	NEG
محظوظه هي تلك الفتاه التي سانقل ملابسي من غساله امي الى غسالتها	POS
مخالفات السير اصبحت تشكل عبئ اقتصادي على المواطن 	NEG
مرره دلوع	NEG
مزعج الي كثييير	NEG
مساكين ها البشر	NEG
مستحيل اثق بذوق حدا ما بحب يسمع لام كلثوم	NEG
مسخره والله	NEG
مسوي انه مندهش	NEG
مش النووي ان صار وما اظنش اسرائيل تسمح باقامته بهالسهوله هو اللي بيعني انو نحن متطورين او متقدمين	NEG
مش باين منيح ليش عم تكذبو	NEG
مش شايف العالم مش ملاقيه الخبز كل واحد بشتغل على سياره رح يوكل هوا بارتفاع المحروقات الاكل الشرب رح يرتفع	NEG
مش طبيعي سماكه الدم شو ها عدوله خرب المفطع لشو المبالغه والاوفر يعني	NEG
مش عاجبو الوضع الي هو فيه	NEG
مش عارف كيف الناس بتحبك يا زلمه؟	NEG
مش عارف كيف اهلهم سمحولهم يقدمو في البرنامج هادول شغل بطون	NEG
مش عارف ليه بيتحوله هما الى دواره عليك وكان نفسهم تكون معاهم فى الاول	POS
مش فاهم عليك لانك صاير غير مفهوم	NEG
مش في محلوا	NEG
مش من بني ادم انتي من جنس الحيوانات	NEG
مشان الله حد يعمله هوشه بدنا نعطللنا شوي	NEG
مشاهد وسخه	NEG
مشتاقه لك شوق ماحسه الناس شوق يغطي معاليق الروح بضمي ترف دلع لهفه مشاعر واحساس ماابي غيرك ولاغيرك تراه همي	POS
مطلوب نصيحه منك لكي نستحضر الخشوع	POS
مع مرور والوقت  وزياده الالتزامات والمسؤوليات قد تنسى ما كنت تستمع	NEG
مع مين بتحكي بتول انشالله مع حالك	NEG
معايا زميل زميل يلعن المسخره كلهم مايستحون ذووولي	NEG
معتيه واضح انهم يمثلون	NEG
معظم اصحاب محطات الوقود وكالات الغاز متنفذين لقد زاد الغني غنى الفقير فقر	NEG
معك حق	POS
معلم في حقيقه عمله هو مدرب يدرب طلاب على اكتساب المعرفه لا مجرد تلقيها	POS
معلومه ممتازه	POS
مفيش اجمل من ان الانسان يحافظ على كرامته	POS
مفيش اكرم ولا ارحم من ربنا	POS
مقاسك غير مناسب يا شريف مع نفسك	NEG
مقال رائع والله يهدي البنات يارب ويرجعهم للصواب	POS
مقرف جدا هذا الشخص	NEG
ملاحظه الكبسه ما بتكهرب والله	NEG
ملحمه بالجامعه الاردنيه	NEG
ملعوب عليهم	NEG
ممرضه هايجه تمارس الجنس مع المريض	NEG
ممكن يكون احسن بالاخلاص	POS
من اجل هذا تم قدوم ?? الف من الجيش الامريكي	NEG
من احبه الله حبب به خلقه	POS
من اسرار النجاح المتواصل والثبات على القمه: العمل الدؤوب والانضباط بالمواعيد والاعمال والتفكير الايجابي	POS
من المدرب مرورا بالمدافعين والوسط الى المهاجمين كلهم كانوا في اسوء حالاتهم	NEG
من الي ضاحك عليهم انو اصواتهم حلوه	NEG
"من اهم مشاكل التعليم الجامعي في الجامعات الرسميه الاردن، مشكله الاعداد حيث ان كل جامعه متجاوزه السقف الاستيعابي لها بالاف الطلاب"	NEG
من اين لنا المياه لتبريد المفاعل النووي فهو يحتاج الى نصف مليون مترا مكعبا من المياه لتبريده سنويا على الاقل والقاصي والداني يعرف اننا في بلد يعاني من شحه المياه اما كعلوم معرفه بالعلوم النوويه الطاقه فانا احب ان يتعلمها المتعلمين في بلادنا بدءا من جدول مندلييف للعناصر مرورا العناصر المشعه نظريه اينشتاين للطاقه نظريات الفيزياء الكميه البحث في عمر البروتون النيوترينو والكواركات واللبتونات وال  النظائر المشعه تفتيت الذره اشعه جاما بيتا الفا الراديوم البلوتونيوم البروتونات كافه النظريات بما فيها انواع المفاعلات النوويه تجارب الامم فيها مثل اليابان المانيا روسيا فرنسا امريكا للعلم فقط انها علوم نظريا سهله بسيطه يستطيع فهمها حتى الانسان ذو الخلفيه الرغبه العلميه على جميع او على الاقل جزء من علمائنا ان يقرروا المسار الذي يجب ان نسلكه نسير فيه بهذا الخصوص بموازنه المخاطر المكاسب بعدها على اساس النتيجه الفائده الواضحه يتم الاعتماد لقرارهم ان كان سلبا ام ايجابا	NEG
من بغضه رب العالمين لن يحبه احد	POS
من ترك شيئا لله عوضه الله خيرا منه	POS
من ترك شيئا لله عوضه الله نورا وايمانا في قلبه	POS
من توكل على الله يعانق قلبه النور الصفاء	POS
من جد سوبر ابقار	NEG
من جد مجنون	NEG
من جد وجد و من سار على الدرب حصد	POS
من دون التفاؤل ما في حياه	POS
من رافق وافق	POS
من زمان ما شفت مخلوقات فضائيه 	NEG
من ضحك عليك وحكالك صوتك حلو	NEG
من قلت الذوق هذه الافعال	NEG
من كانت له عزيمه لن يياس ومن بغي الاجر من الله ثابر  حياكم الله اخي مؤمن	POS
من وين انجيب حرام عليكم	NEG
من يتقي الله يجعل له مخرجا	POS
من يتوكل على الله فهو حسبه	POS
من يستمتع برؤيه الناس في مواقف محرجه فهو سادي غير اصيل نفسه ضعيفه مريضه	NEG
من يوم شفتك حاطه صورتك غسلت يدي منك	NEG
منكو لله نحن لاقيين حق الخبز لحتى ترفعو البنزين صار الواحد يحب يخلص دراسه عشان ما يضل بلاردن لانو ما فيها اشي لا رواتب لا اشي جد بلد مش فقير بس كلو بوكل كلوالله ما بنلوم الحراميه هيك بلد	NEG
منيك ولك	NEG
مهزله التاريخ	NEG
مهزله ياعيب الشووم	NEG
مهو اصلا زي مشروع الباص السريع يلي استملكو عشانه شارع المحطه كامل ليسه بنسمع عنو ما شفنا	NEG
مهيه خربانه ان شاء الله يعملو مفاعل قرد بطلت تفرق	NEG
موضوع اكتر من رائع	POS
مؤامره معروفه ضد الشرفاء في هذا البلد	NEG
مياعه وسئاله من عدوله والي معو	NEG
مين اللي ضاحك عليهم وقايل ان اصواتهم حلوه	NEG
مين بشار العاهه هاد الي بهدد  اي عند الجد والله للنساء والبنات تتطلعن قبل الرجال في هالحاله ونلعن ابو الساعه اللي طلعت بشار وغيره شو هالحكي  الاردن قوي بجيشه وقائده فعلا هززلت قال سوريا قال ولا النعامه او رقبه عاليه بدهها قص	NEG
مين معو دوا للصراصير جد لازمهم رش مبيد حشري للقضاء على هيك حالات متخلفه	NEG
مين هاي الي بصوره وئدامها كورس	NEG
ن مقابله جلاله الملك عبدالله مع قناه سي بي اس الاميركيه . يؤرقني تامين فرص الحياه الكريمه لشباب الاردن و لن نسمح للارهاب بالعبث في الاردن	NEG
نادرا ما بتصير لو انه الشعب بتطور وبيتعلم مع الوقت	NEG
نار جهنم تاخدو	NEG
ناس تبي تتمصخر ماتدري شلون	NEG
ناس عزيزه المعزه لهم غير فيهم صفات الصالحين العليه	POS
ناس مطفره من الاخر	NEG
ناقص و كذاب وما في مصداقيه	NEG
نت عايش خارج البلد عموما ان كان نقاشك فرد عضلات مافيه داعي اكمل حواري معك 	NEG
نتفق معك في ان الرجال يعرفون بالحق ولا يعرف الحق بالرجال	NEG
نجدد قلبنا بالايمان مع بعض	POS
نحن بنتهاوش مع الكتب	NEG
نحن في الاردن نشاطر اخواننا في السعوديه احزانهم بوفاه الامير  سعود الفيصل وزير الخارجيه السعودي السابق انا لله وانا اليه راجعون	NEG
نحن في زمن يهان فيه المرء ويكرم فيه الكلب	NEG
نحن ما بدنا اياه لانا ما منفهم المفاعل النووي فوق طاقتنا صعب علينا بكره بذكركم سالوا الباص السريع الثقه معدومه القمح فاسد المصفاه مش حسب المواصفات الخضار الفواكه مواد كيماويه شوارع مش مصانه حفر مطبات الخ الافضل استغلال الطاقه الشمسيه او الريح او الماء ليس هروب من التطور انما الابتعاد عن الفشل الاكيد عبر التجارب	NEG
نحن نحبك في الله ندعو لك بظهر الغيب	POS
نحن نرفض المفاعل النووي	NEG
نرجو من الله ان يتقبل صلاتنا رغم ما تمر به بلدنا من ازمه صار الواحد خايف على نفسه مستعجل بصلاته انا كلما صليت اعتبرها صلاه مودع فيخشع قلبي تدمع عيناي	POS
نسال الله العفو العافيه	POS
نسال الله تعالى ان تكون بحق ارحنا بها يا بلال ليس ارحنا منه	POS
نسعى بكل همه وجهد للحصول على مصادر طاقه رخيصه تعزز من اقتصاد الاردن كون الطاقه تشكل ربع موازنه الدوله	POS
نسمات انتعاش الفجر رحمات يظفر بها اهل النور التام الذين توسعت صدورهم بانشراح جماعه الفجر حيويه صبح يتنفس منتشيا مرحبا بكل مبادر للخير	POS
نسيانك صعب اكيد	NEG
نشاطر اخوتنا في الاردن احزانهم على الاغتيال الوحشي للطيار  معاذ_الكساسبه داعين الله ان يكون من الشهداء و ان يسكنه فسيح جناته 	NEG
"نظام اقتصاد الاردن فقط لا يتبع اي نظام اقتصادي موضوع، لا اشتراكي ولا راسمالي ولا اسلامي ولا مختلط."	NEG
نعم احسنت واجبه على كل مسلم وحق لكل مسلم فتح الله عليكم	POS
نعم اردنا غير قابل للتلاعب بارواح ابناءه	NEG
نعم الاخ و الصديق اخلاقك تدرس	POS
نعم الاخ وما اطيب قلبه	POS
نعم الصديق الوفى	POS
"نعم الله علي اكثر من ان احصيها الهدايه ، الصحه، سلامهالقلب، ذكاء العقل، صفاء المشاعر ، سلامهالحواس، حفظ الاحباب اللهم لك الحمد"	POS
نعم الوقت يمر بسرعه	POS
نعم فى البدايه كلهم اروع من الروعه	POS
نعم لنجعل حب الله هو الغايه وربنا يسامح كل تائب	POS
نعم مصر عايزه راجل مش واحد وسخ بيقرف	NEG
نعم والحمد لله	POS
نفسي اروح عمره واشوف الكعبه	POS
نفسي افهم من وين جاي يا ابن الكلب	NEG
نفسي يوم اكل وانا مش مستعجله	NEG
نفع الله بك يا دكتور	POS
نقطه النهايه وداعا	NEG
نهارك اسود	NEG
نهارك طيب مبروك	POS
نهايه مواطن طفران	NEG
نيله تنيلكم من وين جايبين هالحثانه	NEG
هات ناس تفهم والمثل بحكي اسال مجرب ولا تسال خبيير	NEG
هاد برنامج وسوبر ستار بنامج شوف البريطان شو بعملو فعلن سوبر الهبل	NEG
هاد كلو كزب ياهبله والله	NEG
هادي الاخوه الصادقه	POS
هاض بعرفو بس مقرف	NEG
هاض بني ادم حقير	NEG
هاكدا هو دين المحبه الصحيح بس للاسف الكثيرين يتبنوه حسب ما يشتهون	POS
هالانسان مجنون لابس بدله رياضه وجاي يغني حتى لو صوتك زين اللبس عدل	NEG
هاي اخلاق خليلنا الحبيب	POS
هاي نتيجه انه ينحط انسان في موقع مسؤوليه	NEG
هدا ماهو عقل هدا تخلوف	NEG
هذا الشخص هو انت يامصطفى	POS
هذا اللى فالحين فيه العرب فقط الهبل التخلف	NEG
هذا اللي انت فالح فيه بس كيف تختار ضحاياك بالسرق جعل العاهه تصيبك ولاعاد تطيب منها ياولد الحرام	NEG
هذا اللي بالنص من لجنه الحكم مفكر نفسو وديع الصافي هو شقفه علاك	NEG
هذا انا واغني وانا بالحمام وانتوا بكرامه صوتي احلا من العاهات هذيل	NEG
هذا تشهير ملعون والدين المفروض ما يعرضونه	NEG
هذا سلامي يسبق البرق الطير فيه الحروف معطره بالتحيه	POS
هذا صدق ولا مجنون ولا يستهبل وش القصه	NEG
هذا عدا عن عنصريتكم البغيضه وجلافتكم وعنجهيتكم الفارغه مع بقيه الشعوب	NEG
هذا لا يعني خلوها من الاشكال المصديه	NEG
هذا ليس مضحك بل مخزى يا للخزى العار	NEG
هذا معوق جنه جورج وسوف	NEG
هذا هو الحب الاصيل الوفي بكل معنى الوفاء	POS
هذا هو الدين	POS
هذا هو المهم	POS
هذا واحد واطي ميمثل غير نفسه 	NEG
هذه البرامج اللي تخلف العاهات للفن الهابط فن اليومين هذا	NEG
هذه جزاء كل من يتطاول على رجال هذه الوطن العزيز	POS
هذه رويدا عطيه يا الخبوول	NEG
هذه مشكله الذي يغني كثيرا في الحمام ويتصور انه اصبح مطرب	NEG
هذه من اقوال الرفيق المناضل	POS
هذول مجانين اكيد ما بوافق مش هبله انا	NEG
هذول مخانيث	NEG
هذول مساجين ولا ايش	NEG
هع بدها بس تعلق التعليقات الزنخه	NEG
هع مش حلو	NEG
هكذا المسلمون	POS
هل الثقه بالمشتركين الزياده لدرجه العمى او ان محيطهم يجاملهم بجمال صوتهم	NEG
هل تعلم ان المطر يتشكل اولا على هيئه بلورات ثلج داخل الغيوم يتحول الى قطرات ماء بعد ذوبانه هو في طريقه الى اليابسه	POS
هل كلها صالحه للاستعمال ولا من اول استخدام تنفجر	NEG
هلا كففت عن قسوتك	NEG
هم اللي مصخرو انفسهم	NEG
هما بس الى بيسعوا للغناء ده طبعا غير الاشتغالات والافلام الهندى الى نحن شفنها	NEG
هنا نجد اصحاب السوء يحضرون بقوه لان ها هولاء لم يحظروالى بعد تشجيع من اناس حولهم	NEG
هههه انا من ناحيتي هاظ الانسان الي قاعد بلنص اقرف واحد	NEG
هو بن وسخه ادمان وبالذات لو متابع اخبار وحاجات يوميه	NEG
هو رحيم بكل شىء في الكون هو الخالق فلابد ان يرزق مخلوقاته	POS
هو فى حد اساسا لسه بيتابع البت دي هاي عنجد بتقرف	NEG
هو نحن خلينا نخلص ام هالبرجين الللي صرلهم 16 سنه بعدين بنفكر نعمل نووي سلمي من الديسي	NEG
هو هذا اسلامك يا زاني	NEG
هؤلاء معوقين	NEG
هي عندها صوت قوي بس للاسف الحين مثل غيرها	NEG
هي فلسطين راحت من قليل يا ولاد المخنثه لعنه الله عليكم فظحتونا	NEG
هيك بدهم الخونه اتباع ايران الاخوان المفسدون	NEG
و اذا فادنا بشي رح يكون في خساره كبيره بالاخر	NEG
و الناس يدرون شو بقول عنهم في نفسي وهم يتكلمون ما يكلمني حدا نهائي	NEG
و الى اسماء الاسد كـــس اخـــت زوجـــك :	NEG
و بحب الناس الرايقه الي بتضحك على طول	POS
و تربت على كتوفنا تشحننا بالتفاؤل ايضا صباحك اسعد	POS
و ما من دابه في الارض لا طائر يطير بجناحيه الا على الله رزقه	POS
و مفيش احلى من قضاء ربنا	POS
و نرجو لك دوام الخير المحبه من الله من الناس	POS
و هكذا جنت على نفسها براقش	NEG
و يرزقكم من حيث لا تعلمون	POS
واثق من نفسه الحبيب	NEG
واحد هامل	NEG
واحد واطي	NEG
وادم علينا يارب نعمه الامن والامان وسائر بلاد المسلمين	NEG
واذكر ربك اذا نسيت وقل عسى ان يهدينى ربى لاقرب من هذا رشدا	POS
واسال الله من اثواب رحمته سترا جميلا على الزلات مشتملا وان ييسر لي سعيا اكون به مستبشرا جذلا لا باسرا وجلا *	POS
واضح جدا ان اغلب الناس هاي عندها مشاكل نفسيه	NEG
واطي وماجور وسافل ومنحط وكريه وغبي وسطحي وحقو قرش مصدي وبيسوى صرمايه	NEG
واعظمها امه سيدنا محمد	POS
والحاجه الي انت بتحبها دي هي مش اكتر من حاجه زينها الشيطان واقنعك بحلاوتها بس هتندم بعدين	POS
والشرهه على الاغبياء اللي معطينك لايك	NEG
والشكرلله والفضل لله على هذه النعمه التي انعم الله علينا بها وجعلنا من الماء كل شي حي	POS
والغناء تجد لك ??? مليون وكلهم زباله	NEG
والله احلا شيء انه الواحد يهاجر او يشتغل حرامي عشان يقدر يعيش الله لا يوفق الي كان السبب الله حرام	NEG
والله الحياه كلها بتخزي بدونكم	NEG
والله الرساله دي جاتلي في وقتها قولت اكيد ربنا بعتهالي الحمد لله وخات القرار	POS
والله الناس دي ما شايله هم ابدا علشان كده مسخرو نفسهم او كرامتهم راحت	NEG
والله الواحد بيدعي كثيرا ان ربنا يجعلنا في طريق مستقيم	POS
والله انا خايف انو طخوا بعد هاي الصوره	NEG
والله انك فشلت العرب	NEG
والله انك ما زليه يا شيخ اكيد مدفوعله من تحت تحت	NEG
والله انك مسخره يا عجوز	NEG
والله انك مهزله	NEG
والله انكو ما بتخافوالله	NEG
والله انو مكب نفايات نوويه انا اشتغلت بالمفاعل موقعه بعلان بالسلط	NEG
والله انو نذل	NEG
والله اول واحد سمعته منهم احسب سماعتي خربا يا بطني من الضحك والله زاحفين	NEG
والله ايلى اختشه ماتوا	NEG
والله بذل نفسي مره اثنين خمسين عشان الغرام الحلال احلى لكن مين يحس يفهم يقدر	POS
والله تحشيش من الاخر	NEG
والله ثقف نفسك ده بيقول كلام زى الفل	POS
والله حرام الناس مش لاقيه توكل حتى ترفعو البنزين	NEG
والله حرام تكاليف زواج ومهر واخرتها طلاق بسبب شي تافهه	NEG
والله حرام والله موتوه لشعب الاردني من وين بدنا نجيب الكو من وين يا الله ارحمو من في الارض يرحمكم من في السماء الله حرام	NEG
والله حرام يعني ما يدرون انهم مصخره	NEG
والله حرق لاخوات الكلب	NEG
والله رفعتوا راسنا يا شباب الله يقويكم	POS
والله شككني في البرنامج انه سوبر ستار او برنامج كوميدي	NEG
والله شوي وتجيني جلطه لما ماطلعت الاولى ذيك المره	NEG
والله شويه عبط الي بيغنو والحكام كمان	NEG
والله ظلموه لجنه الطراطير	NEG
والله عاهات	NEG
والله على بالي مجنون	NEG
والله عيب بهدلتو حالكم	NEG
والله قررات من دلواتى يا مصطفى بس انا عاز رايك فى حاجات كتير	POS
والله كذب من سوبر ستار القذر هذا	NEG
والله لو انه فايز بعرب ايدول او من هل برامج الفارطه غير تلاقي اضعاف هذا العدد ياعمي شعب بحب السح اندح	NEG
والله لو طلبوا مين اللي عندو قلب قوي ??? متر للجري مايتقدم ولا حمار عربي	NEG
والله لو يجمعونهم على شاطئ البحر الميت ويخلونهم يصرخون على اليهود ولمده 30 ثانيه ليهربون لقبرص عن طريق البحر سباحه	NEG
والله ما في اشي مزعلني الا انه اسمه محمد	NEG
والله ما يحرر عزبت بنقاليه	NEG
والله مش طبيعي حرام الله غير تنتشر السرقه النهب خرب الامان النشور	NEG
والله مش عارفه شو بدنا نسوي نشحد مثلا	NEG
والله نحن مو ناقصنا وجع قلب بس ضايل علينا النووي و صحه البشر مش برضو خطيه المسؤولين ? خلص ما عاد في شي فارق والله عحب	NEG
والله نفسى بس الواحد بيجى عليه فترات ينسى يعمل ايه بجد	POS
والله نوفي صح لسانك	NEG
والله هبل في هبل	NEG
والله هذا الى حصل معانا ومع ناس كثيره بدل حب الحرام بحب الحلال يبدل الله كيانك	POS
والمصحف عاهات	NEG
والنعم والاخلاق والنعم والصداقه والنعم الاخوه	POS
وان مدحتك بالقصائد ماوفيت	POS
وانا 100% بس شكلها هاي مو مدرسه	NEG
وانا مع انو الطاقه الشمسيه هي البديل	NEG
وانا من الناس اللي فعلا محتاجين يحاسبوا نفسهم ويصلحو من نفسهم لاننا عارفين انه لا ملجا لنا الا لله	POS
وانت اسكت لا تتحطم	NEG
واي ناس فاظيين صج عاهات	NEG
وبعدين تري مالقت دعم	NEG
وبكل تبلد اعترف لكم  باني اقل نساء الارض صبرا	NEG
وجعتو راسي	NEG
وجعلنا من الماء كل شيء حي	POS
وجه الفطيره قبل تعيب الناس انظر الى حالك	NEG
وجه حسن وضحكه تفتح النفس وعيون خلابه	POS
وجهك مش الك	NEG
ودي اكسر الابتوب على راسه	NEG
وذلك ليذوقوا ايران وسوريا وشيعتهم وبال امرهم	NEG
وربي عاهات مستعصيه	NEG
وربي كلبتي جات جلست عندي اول ما فتحت هالفيديو ويوم خلص التفت لها الا والاقيها نايمه	NEG
وزير التعليم العالي: لا زياده للدعم المالي للجامعات خلال السنوات الثلاث المقبله	NEG
وسبب برفعه ضغطك	NEG
وسدئيني انكووو كلاب	NEG
وش التخلف هذا	NEG
وش جابني هنا ثقيلين دم	NEG
وش فيك معصب خلاص بعطيك اللايك الي جاني خخخ	NEG
وش هالتحف والله مساكين ماكلين مقلب بقوه	NEG
وش يحسون فيه يع	NEG
وش يحسووون فيه ناس مهبل	NEG
"وعجلت اليك ربي لترضي : كن كالمطر، اذا اقبل استبشر الناس به واذا حط نفعهم ، واذا رحل ترك اثرا نافعا فيهم واذا غاب اشتاقوا اليه ."	POS
وعرض اختي انك لاسع يادمن عساس لو بدها تضرب من هسه خايفه منك	NEG
وعلي الله قصد السبيل	POS
وقّـف قلبو لحسن الشافعي	NEG
وقعنا ولا ما وقعنا يللي بدهم يعملوه بيعملوه	NEG
ولا انا صورتي كذا اجي اهبال هوو	NEG
ولا بقلو بيضه	NEG
ولا تنسو تبسمك في وجه اخيك صدقه	POS
ولا جورج في الزمنات بس حرام يفضحوهم	NEG
ولا خير في امرٍ كرهت ان يطّلع عليه الناس	NEG
ولا شكل ولا صوت منين جايبينهم هالكائنات الغريبه اه يا بطني بس	NEG
ولا مستحيل يطلع واحد يفشل نفسه كذا	NEG
ولاه امرك الوهابيين يكرعون الخمر والسديقي كرعا بالسر والعلن دون تطبيق الحدود عليهم	NEG
ولك تفيييه عليك	NEG
ولك واحد كندره	NEG
ولكن كيف ان المفاعل النووي غير مضر بالبيئه فهمني ؟؟	NEG
ولكوم ما نحن ميتين من دون هالوسطه	NEG
ولو هو انسان وعنده احاسيس ممكن من هالموقف اللي الكل يشوفه يتعقد هالانسان من حياته كلها	NEG
وماذا عن التفاؤل في يوم ربيعي جميل نحقق به الامال الطوال	POS
ومن احسن قولاممن دعالي وعمل صالحاووقال انني من المسلمين 	POS
ومن خسئ الشيعه اخوان القرده الخنازير	NEG
ومن منطلق المسؤوليه التاريخيه للهاشميين تجاه المقدسات ياتي اهتمام الهاشميين بالقدس ومقدساتها	POS
ونشوف اغلى الاحبه في الروضه الرحيبه	POS
ونعم بالله العلي العظيم ونعم بالله عزوجل	POS
ونعم بالله من اختار قرب الله فما خاب ابدا الله على دى راحه وده شعور الحمد لل	POS
وهابي تاج راسك يا اللي تاكل من وراك اذا في الوهابيه شئ مخالف لكتاب الله سنه نبيه اذكره لا تكون كالببغاء تردد خلف الناعقين لتثبت انك على الصراط انت في هوه الخراب طنت من طنوت سوريا	NEG
وهابي عفن ومكبوت تفكيرك محصور بين فخذيك فقط لاغير الجنه اللتي ستدخلها انت لا اريد دخولها  جهنم اشرفلي واهون علي من ان اكون مع احد الوهابين المنحطين لواطيي الاطفال	NEG
وهاد اللي بخبص حكي ملوش معنا ابن مين هاد	NEG
وهاي المضروبه جايخه على وين	NEG
وهذه من اكبر المشاكل التي تؤرق الشباب في هذه الايام	POS
وياريت بتظبط الكذب ماوش رجلي	POS
ويحطمو رؤوسهم بارجلهم	NEG
وين القناه التافه الى تعرض هذول المعاتيه صحيح نحن في انحطاط	NEG
وين الماء كل يوم الميه مقطوعه	NEG
وين بدهم يروحو يعني خالصه	NEG
يا اخوان انتبهوا الى انه اكثر المشتركين المايعين من لبنان او سوريا وهذا حالهم لان تركوا مله الاسلام وتبعوا الميوع مع الشيطان	NEG
يا اخوان نحن قرفنا	NEG
يا اخي اطلع في صورتك بالمرايه وشوف ادائك هوه اداء فني+صوت مناسب قبل لا تفضح حالك في هيك برامج تافهه	NEG
يا اخي وين ما تروح بالاردن تخطى مناطق الشخصيات المهمه بالبلد الباقي كله مكرهه صحيه	NEG
يا ارحم الراحمين يا الله	POS
يا الله ارحم عبدك الفقير المسكين وجميع المسلمين والمسلمات	POS
يا الله استجب دعائي يالله مادكيت بابك يوم ورحعتني خاليه الوفاض	POS
يا الله عالمواساه يرحم ايام زمان	POS
يا الله كلامك بلسم	POS
يا الله ما احلاه من خبر والله فرحتوني	POS
يا ترى الحكومه بدها تزيد دعم المواطن الي الله يكون في عونه	NEG
يا حبيبي هاي صار للرجال تنانير؟ تفي هيك رجاله	NEG
يا خساره عليكو يا شباب المستقبل	NEG
يا رب اجعلنا من الصالحين	POS
يا رب ارزقنا الفرح والسعاده	POS
يا رب اريد تجديد ايماني ساعدني	POS
يا رب استجب دعائنا وانصر اهلنا في سوريا	POS
يا رب اسعد قلبي و قرب لي الخير	POS
يا رب اللهم اجعلنى خير مما يظنون اغفر لى ما لا يعلمون	POS
"يا رب ان امسيت بحزن فاصبحني بفرح، و ان نمت على ضيق فايقظني على فرج و ان كنت بحاجه فلا تكلني الا لسواك"	POS
يا رب بناتنا شبابنا كلهم يستطيعوا العمل بهذه النصيحه يا ريتا كلنا نتذكر اننا كلنا دعاه للاسلام باخلاقيتنا الصفات الحسنه	POS
يا رب خد بيدنا يا جبرنا يا جبار السموات والارض	POS
يا رب رضينا امنا صدقنا فارضينا برضاك عنا اجبر كسر قلوبنا هون علينا	POS
يا رب قويني علي نفسي يا رب تقبل منا الله	POS
يا رب نستغفرك ونتوب اليك يا رب ما لنا سواك	POS
يا رب يا خير الرازقين ارزق اهل سوريا جميع المسلمين النصر الثبات التقوى	POS
يا رب يكرمنا باولادنا انا دائما بشجع ابني ان يكون كالجبل الذي لا تهزه الرياح العاتيه	POS
يا ربي شو هالولد الله مجنون مبيستحييش متاكدين انو مغربي	NEG
يا ربي هذا مستحيل يكون كائن بشري	NEG
يا ريت لو يعملوا دورات قبل الزواج	POS
يا ريتك ما كبرت	NEG
يا سلام على الوفاء اللي اتفقد في عصرنا ويا حسرتاه على الحب الذي بات مجرد كلمات	POS
يا سلام ما احلى ان يواسي المسلم اخاه هذه هي اخلاق الاسلام 	POS
يا سيدي هدول عاهات ولله يعني فيك تسحب عليهم قرض من البنك كونهم عاهات	NEG
يا طيب صباحك كل خيرات	POS
يا طيبه الخير جينا يا طيبه بالروح افتدينا	POS
يا ظالم الك يومك	NEG
يا عطاء يامنان يا اكرم الاكرمين	POS
يا عني علي ذكرك شكرك حسن عبادتك	POS
يا غبي كوادر الاخوان المسلمين في كل بقعه من هالارض	NEG
يا فضيحتك يا لبنان بهيك عالم اما هيدا سكت اني ولك دخيل الله خليك ساكت	NEG
يا لطيف الله يلطف فينا يصلحنا ظاهر باطن	POS
يا لله ارحم احبتي و شافيهم وعافيهم واعف عنهم	POS
يا مصلح القلوب اصلح احوالنا يا مسهـل يا رب	POS
يا مقلب القلوب ثبت قلوبنا على الاسلام	POS
يا مقلب القلوب والابصار ثبت قلبى على دينك	POS
يا من يرزق النعاب في عشّه هيّء لنا مقادير	POS
يا هيك الاكل يا بلا لش الحكي	POS
ياجماعه يقولون بشار الاسد مات	NEG
ياخساره العروبه فيك	NEG
ياخي برنامج سامج ساذج	NEG
يارب اجعلنى من الصالحين	POS
يارب اجمع امتك علي دينك يارب وشت اعداء الدين	POS
يارب احمينا من شرور انفسنا وسىئات اعمالنا	POS
يارب اخرجنا من ذل المعصيه الي عز الطاعه	POS
يارب ارزق العزيمه لاتخاذ القرار ويا رب اخلفنا خيرا منه	POS
يارب اعنا علي ترك المعاصي ماحيينا	POS
يارب اعيني علي دكرك وشكرك وحسن عبادتك	POS
يارب اغفر لي ذنبي وارزقني حبك هو ربنا ممكن يكره حد لو فضل يكرر ذنبه بعد الاستغفار	POS
يارب انت المستعان فاعنا واهدنا يارب الكون اجمع استجب	POS
يارب اهدنا وقوى عزيمتا الى ما تحب وترضى	POS
يارب اهدي بنات وشباب المسلمين الي ما يرضيك عنهم وكفيهم شر فتن الدنيا والاخره	POS
يارب تهدينا الي الصراط المستقيم يارب تقبل منا	POS
يارب توب علينا وساعدنا نتوب وبصرنا بعيوبنا لان ساعات كتير بننسه	POS
يارب ثبتنا بعد اخذ القرار لان هو ده الاهم الاصعب	POS
يارب دعوناك فستجب لنا وحقق لنا ماهو اصلح وافضل لنا	POS
يارب ساعدني وقويني وساعدني اخد حبيبي	POS
يارب طهر قلوبنا يارب اهدينا للصواب	POS
يارب عوضنا خير مما اخذ منا	POS
يارب قربني اليك واقترب لي اكثر	POS
يارب كرهنى وابعدنى فيما يغضبك	POS
يارب ناخذ القرار الصح	POS
يارب وانت ادعيلي	POS
يارب يتقبل منا والله العقل مو فاضي والقلب مكسور	POS
يارب يقدرنا على ادخال المياه النظيفه لكل بيت محتاجه المياه	POS
يارب يقوينا جميعا على طاعته وحسن عبادته	POS
ياريت حدا عم يواسي السوريين بغربتهن للاسف باب رزق جديد للعرب	POS
يازم والله ماعندكم غير الكذب ع الناس	NEG
"يالا من هون كس امك انت و هو، بلاش قرف و وساخه"	NEG
يالله ما اروع هائولاء الناس	POS
ياي ما ازكى هذا الاكل	POS
يتسابقون الى جهنم و باس المصير	NEG
يجب دائما ان نعتني بالورود لكي تكبر	POS
يجب على الحكومه العوده بالتوقيت الى الساعه الثالثه	NEG
يجب على المسلم ان يواسى اخوه فى الاسلام	POS
يجب على كل مسلم الاعتزاز بدينه في جميع الامور صغيرها كبيرها	POS
يجب وضع كل من تسول له نفسه مجرد ان يعمل اي تصرف لا يليق بالاردن ان يسجن يسجن شىء مخزي شويه همل زعران يخربوا الجامعات سمعه البلد	NEG
يجيز ارضاع شرق اسيا كلها لكن قياده المراه للسياره فسق وفجور	NEG
يخرب الدلع	NEG
يخرب بيتك ما ازنخك	NEG
يخسو الشيعه الخنزير	NEG
يرزق من يشاء بغير حساب	POS
يسعد صباحك بذكر الرحمن	POS
يشبه رغد مجنونه هيافاء	NEG
يشم الطيب ويتعطر يا دكتور	POS
يضحكون م شاففوا انفسهم لو قلنا غنوا جابوا الععيد فالحين بس في الظرافهه الشيبان	NEG
يع بتقرف انت وسخ يع شوهاي الوساخه	NEG
يع حاسه حالي بدي استفرغ	NEG
يعتبر الترمس من المصادر الطبيعيه لفتح الشهيه وتقويه الاجسام الهزيله؛ لانه غني بالكالسيوم والفوسفور. 	POS
يعطيك العافيه	POS
يعني الواحد بغلط غلطه بالجامعه بدون ما ياثر عحدا غير حاله بروحوا بمنعوه يدخل كل جامعات الاردن	NEG
يعني بكل وضوح بدكوا تذلوا الشعب الاردني تخلوه كل شهور يصف طابور عشان يوخدلوا اكمن ليره	NEG
يعني دوله اللي  من وين جاي كيف وصل عشان تشوفه لجنه التحكيم مبين عليه مجنون مش شايف اشي قدامه	NEG
"يعني كل جامعات الاردن عندهم نظام، و احنا عنا خرا"	NEG
يعني لو عايزين يبعوه بلغوني من القرف هاض يع يع يع	NEG
يعني ما اختار الا الاغنيــه اللي اغلب احرفها الحرف اللي يقرط فيه	NEG
يعني هيك برامج بتبين للناس وين صرنا كم صارت نسبه التخلف بين شباب امتنا	NEG
يعني يجبون كم واحد يعطونهم فلوس ويجون يستهبلوا عندهم عشان يحركون البرنامج	NEG
يلعن ابو التخلف والغباء والبياخه	NEG
يلعن ابو التفاهه	NEG
يلعن ابو الي ما بستحي	NEG
يلعن ابو هل الاشكال بس	NEG
يلعن اخت المياعه والبياخه	NEG
يلعن الساعه الي بشرت فيك	NEG
يلعن ام الازعاج	NEG
يلعن ام السخافه	NEG
يلعن شرف خواتك	NEG
يلعنك نذل وكلب	NEG
يمتاز الاردن بتنوع السياحه فيه فتنقسم السياحه الى  سياحه علاجيه   سياحه دينيه   سياحه معارض   سياحه اثار	POS
ينور عليك ويكثر من امثالك	POS
يهدي الله من يشاء	POS
